8
0
1 1
21 21
- - - - - - - - - - - - - - - - - - - - - 
- 0 0 0 0 0 0 - 0 0 0 0 0 0 - 0 0 0 0 0 0 
- 0 0 0 0 0 0 - 0 0 0 0 0 0 - 0 0 0 0 0 0 
- 0 0 1 5 0 0 - 0 0 8 4 0 0 - 0 0 3 8 0 0 
- 0 0 5 1 0 0 - 0 0 4 8 0 0 - 0 0 8 3 0 0 
- 0 0 0 0 0 0 - 0 0 0 0 0 0 - 0 0 0 0 0 0 
- 0 0 0 0 0 0 - 0 b 0 0 b 0 - 0 0 0 0 0 0 
- - - - - - - - - - - - - - - - - - - - - 
- 0 0 0 0 0 0 - - - - - - - - 0 0 0 0 0 0 
- 0 0 0 0 0 b - - - - - - - - b 0 0 0 0 0 
- 0 0 6 2 0 0 - - - i i - - - 0 0 2 7 0 0 
- 0 0 2 6 0 0 - - - i i - - - 0 0 7 2 0 0 
- 0 0 0 0 0 b - - - - - - - - b 0 0 0 0 0 
- 0 0 0 0 0 0 - - - - - - - - 0 0 0 0 0 0 
- - - - - - - - - - - - - - - - - - - - - 
- 0 0 0 0 0 0 - 0 b 0 0 b 0 - 0 0 0 0 0 0 
- 0 0 0 0 0 0 - 0 0 0 0 0 0 - 0 0 0 0 0 0 
- 0 0 7 3 0 0 - 0 0 4 5 0 0 - 0 0 6 1 0 0 
- 0 0 3 7 0 0 - 0 0 5 4 0 0 - 0 0 1 6 0 0 
- 0 0 0 0 0 0 - 0 0 0 0 0 0 - 0 0 0 0 0 0 
- 0 0 0 0 0 0 - 0 0 0 0 0 0 - 0 0 0 0 0 0 
8 6 5 <-> 6 8 1
13 6 3 <-> 15 8 7
1 13 5 <-> 1 15 7
15 13 5 <-> 13 15 1
8 15 7 <-> 6 13 3
1 8 7 <-> 1 6 5
20 6 3 <-> 20 8 1
20 13 3 <-> 20 15 1
15 20 5 <-> 13 20 3
8 20 5 <-> 6 20 3
15 6 5 <-> 6 15 1
6 6 3 <-> 15 15 7
1 1 7 <-> 1 1 0
20 20 3 <-> 20 20 4
20 1 0 <-> 20 1 1
10 6 4 <-> 10 10 0
6 11 2 <-> 10 11 6
11 15 0 <-> 11 11 4
11 10 2 <-> 15 10 6
10 11 4 <-> 10 10 6
11 10 0 <-> 11 11 2
6 1 1 <-> 8 1 7
1 20 5 <-> 1 20 4
15 1 7 <-> 13 1 1
