8
4
0 30 
49 49
0 0 0 0 0 0 0 0 0 0 0 0 0 0 0 0 0 - 0 0 0 0 0 0 - 0 0 0 0 0 0 - 0 0 0 0 0 0 0 0 0 0 0 0 0 0 0 0 0
0 0 0 0 0 0 0 0 0 0 0 0 0 0 0 0 0 - 0 0 0 x 0 0 - 0 0 x 0 0 0 - 0 0 0 0 0 0 0 0 0 0 0 0 0 0 0 0 0
0 0 - - - - 0 0 - - - - 0 0 0 0 0 - 0 x 0 x 0 0 - 0 0 x 0 x 0 - 0 0 0 0 0 - - - - 0 0 - - - - 0 0
0 0 - 0 0 0 0 0 0 0 0 - 0 0 0 0 0 - 0 0 x 0 x 0 - 0 x 0 x 0 0 - 0 0 0 0 0 - 0 0 0 0 0 0 0 0 - 0 0
0 0 - 0 0 0 0 0 0 0 0 - 0 0 0 0 0 - 0 0 x 0 0 0 - 0 0 0 x 0 0 - 0 0 0 0 0 - 0 0 0 0 0 0 0 0 - 0 0
0 0 - 0 0 0 0 0 0 0 0 - 0 0 0 - - - 0 0 0 0 0 0 - 0 0 0 0 0 0 - - - 0 0 0 - 0 0 0 0 0 0 0 0 - 0 0
0 0 0 0 0 0 1 2 0 0 0 - 0 0 0 0 0 - - - - - - - - - - - - - - - 0 0 0 0 0 - 0 0 0 8 7 0 0 0 0 0 0
0 0 0 0 0 0 2 1 0 0 0 - 0 0 0 - - - 0 0 0 0 0 0 0 0 0 0 0 0 0 - - - 0 0 0 - 0 0 0 7 8 0 0 0 0 0 0
0 0 - 0 0 0 0 0 0 0 0 - 0 0 0 0 0 0 0 0 0 0 0 0 0 0 0 0 0 0 0 0 0 0 0 0 0 - 0 0 0 0 0 0 0 0 - 0 0
0 0 - 0 0 0 0 0 0 0 0 - 0 0 0 6 5 0 0 0 0 0 0 0 0 0 0 0 0 0 0 0 3 4 0 0 0 - 0 0 0 0 0 0 0 0 - 0 0
0 0 - 0 0 0 0 0 0 0 0 - 0 0 0 5 6 0 0 0 0 0 0 0 0 0 0 0 0 0 0 0 4 3 0 0 0 - 0 0 0 0 0 0 0 0 - 0 0
0 0 - - - - 0 0 - - - - 0 0 0 0 0 0 0 0 0 0 0 0 0 0 0 0 0 0 0 0 0 0 0 0 0 - - - - 0 0 - - - - 0 0
0 0 0 0 0 0 0 0 0 0 0 0 0 0 0 0 0 0 0 0 0 0 0 0 0 0 0 0 0 0 0 0 0 0 0 0 0 0 0 0 0 0 0 0 0 0 0 0 0
0 0 0 0 0 0 0 0 - - - - - - - - - - 0 0 0 0 0 - 0 - 0 0 0 0 0 - - - - - - - - - - 0 0 0 0 0 0 0 0
0 0 - 0 0 - 0 0 - 0 0 0 0 0 0 0 0 - 0 0 0 0 0 - 0 - 0 0 0 0 0 - 0 0 0 0 0 0 0 0 - 0 0 - 0 0 - 0 0
0 0 0 - - 0 0 0 - 0 0 0 0 0 0 0 0 - 0 0 0 0 0 - - - 0 0 0 0 0 - 0 0 0 0 0 0 0 0 - 0 0 0 - - 0 0 0
0 0 0 - - 0 0 0 - 0 0 0 0 0 0 0 0 - 0 x 0 0 0 0 - 0 0 0 0 x 0 - 0 0 0 0 0 0 0 0 - 0 0 0 - - 0 0 0
0 0 - 0 0 - 0 0 0 0 0 0 6 5 0 0 0 - - 0 0 0 0 0 - 0 0 0 0 0 - - 0 0 0 3 4 0 0 0 0 0 0 - 0 0 - 0 0
0 0 0 0 0 0 0 0 0 0 0 0 5 6 0 0 0 - - 0 0 0 0 0 - 0 0 0 0 0 - - 0 0 0 4 3 0 0 0 0 0 0 0 0 0 0 0 0
0 0 0 0 0 0 0 0 - 0 0 0 0 0 0 0 0 - 0 x 0 0 0 0 - 0 0 0 0 x 0 - 0 0 0 0 0 0 0 0 - 0 0 0 0 0 0 0 0
- - - 0 0 0 0 0 - 0 0 0 0 0 0 0 0 - 0 0 0 0 0 - - - 0 0 0 0 0 - 0 0 0 0 0 0 0 0 - 0 0 0 0 0 - - -
0 0 0 0 0 0 0 0 - 0 0 0 0 0 0 0 0 - 0 0 0 0 - - 0 - - 0 0 0 0 - 0 0 0 0 0 0 0 0 - 0 0 0 0 0 0 0 0
0 0 0 0 0 0 0 0 - - - - - - - - - - 0 0 0 - - 0 0 0 - - 0 0 0 - - - - - - - - - - 0 0 0 0 0 0 0 0
0 0 0 0 - - - 0 0 0 0 0 0 0 0 0 0 0 0 0 - - 0 x 0 x 0 - - 0 0 0 0 0 0 0 0 0 0 0 0 0 - - - 0 0 0 0
0 0 0 0 0 0 - - 0 0 0 0 0 0 0 0 0 0 0 - - 0 0 0 b 0 0 0 - - 0 0 0 0 0 0 0 0 0 0 0 - - 0 0 0 0 0 0
0 0 0 0 - - - 0 0 0 0 0 0 0 0 0 0 0 0 0 - - 0 x 0 x 0 - - 0 0 0 0 0 0 0 0 0 0 0 0 0 - - - 0 0 0 0
0 0 0 0 0 0 0 0 - - - - - - - - - - 0 0 0 - - 0 0 0 - - 0 0 0 - - - - - - - - - - 0 0 0 0 0 0 0 0
0 0 0 0 0 0 0 0 - 0 0 0 0 0 0 0 0 - 0 0 0 0 - - 0 - - 0 0 0 0 - 0 0 0 0 0 0 0 0 - 0 0 0 0 0 0 0 0
- - - 0 0 0 0 0 - 0 0 0 0 0 0 0 0 - 0 0 0 0 0 - - - 0 0 0 0 0 - 0 0 0 0 0 0 0 0 - 0 0 0 0 0 - - -
0 0 0 0 0 0 0 0 - 0 0 0 0 0 0 0 0 - 0 x 0 0 0 0 - 0 0 0 0 x 0 - 0 0 0 0 0 0 0 0 - 0 0 0 0 0 0 0 0
0 0 0 0 0 0 0 0 0 0 0 0 7 8 0 0 0 - - 0 0 0 0 0 - 0 0 0 0 0 - - 0 0 0 2 1 0 0 0 0 0 0 0 0 0 0 0 0
0 0 - 0 0 - 0 0 0 0 0 0 8 7 0 0 0 - - 0 0 0 0 0 - 0 0 0 0 0 - - 0 0 0 1 2 0 0 0 0 0 0 - 0 0 - 0 0
0 0 0 - - 0 0 0 - 0 0 0 0 0 0 0 0 - 0 x 0 0 0 0 - 0 0 0 0 x 0 - 0 0 0 0 0 0 0 0 - 0 0 0 - - 0 0 0
0 0 0 - - 0 0 0 - 0 0 0 0 0 0 0 0 - 0 0 0 0 0 - - - 0 0 0 0 0 - 0 0 0 0 0 0 0 0 - 0 0 0 - - 0 0 0
0 0 - 0 0 - 0 0 - 0 0 0 0 0 0 0 0 - 0 0 0 0 0 - 0 - 0 0 0 0 0 - 0 0 0 0 0 0 0 0 - 0 0 - 0 0 - 0 0
0 0 0 0 0 0 0 0 - - - - - - - - - - 0 0 0 0 0 - 0 - 0 0 0 0 0 - - - - - - - - - - 0 0 0 0 0 0 0 0
0 0 0 0 0 0 0 0 0 0 0 0 0 0 0 0 0 0 0 0 0 0 0 0 0 0 0 0 0 0 0 0 0 0 0 0 0 0 0 0 0 0 0 0 0 0 0 0 0
0 0 - - - - 0 0 - - - - 0 0 0 0 0 0 0 0 0 0 0 0 0 0 0 0 0 0 0 0 0 0 0 0 0 - - - - 0 0 - - - - 0 0
0 0 - 0 0 0 0 0 0 0 0 - 0 0 0 7 8 0 0 0 0 0 0 0 0 0 0 0 0 0 0 0 2 1 0 0 0 - 0 0 0 0 0 0 0 0 - 0 0
0 0 - 0 0 0 0 0 0 0 0 - 0 0 0 8 7 0 0 0 0 0 0 0 0 0 0 0 0 0 0 0 1 2 0 0 0 - 0 0 0 0 0 0 0 0 - 0 0
0 0 - 0 0 0 0 0 0 0 0 - 0 0 0 0 0 0 0 0 0 0 0 0 0 0 0 0 0 0 0 0 0 0 0 0 0 - 0 0 0 0 0 0 0 0 - 0 0
0 0 0 0 0 0 4 3 0 0 0 - 0 0 0 - - - 0 0 0 0 0 0 0 0 0 0 0 0 0 - - - 0 0 0 - 0 0 0 5 6 0 0 0 0 0 0
0 0 0 0 0 0 3 4 0 0 0 - 0 0 0 0 0 - - - - - - - - - - - - - - - 0 0 0 0 0 - 0 0 0 6 5 0 0 0 0 0 0
0 0 - 0 0 0 0 0 0 0 0 - 0 0 0 - - - 0 0 0 0 0 0 - 0 0 0 0 0 0 - - - 0 0 0 - 0 0 0 0 0 0 0 0 - 0 0
0 0 - 0 0 0 0 0 0 0 0 - 0 0 0 0 0 - 0 0 x 0 0 0 - 0 0 0 x 0 0 - 0 0 0 0 0 - 0 0 0 0 0 0 0 0 - 0 0
0 0 - 0 0 0 0 0 0 0 0 - 0 0 0 0 0 - 0 0 x 0 x 0 - 0 x 0 x 0 0 - 0 0 0 0 0 - 0 0 0 0 0 0 0 0 - 0 0
0 0 - - - - 0 0 - - - - 0 0 0 0 0 - 0 x 0 x 0 0 - 0 0 x 0 x 0 - 0 0 0 0 0 - - - - 0 0 - - - - 0 0
0 0 0 0 0 0 0 0 0 0 0 0 0 0 0 0 0 - 0 0 0 x 0 0 - 0 0 x 0 0 0 - 0 0 0 0 0 0 0 0 0 0 0 0 0 0 0 0 0
0 0 0 0 0 0 0 0 0 0 0 0 0 0 0 0 0 - 0 0 0 0 0 0 - 0 0 0 0 0 0 - 0 0 0 0 0 0 0 0 0 0 0 0 0 0 0 0 0
5 24 2 <-> 21 24 6
43 24 6 <-> 27 24 2
24 14 4 <-> 24 21 0
24 34 0 <-> 24 27 4
16 6 2 <-> 32 6 6
16 42 2 <-> 32 42 6


