8
1
1 5
24 25
0 0 0 0 0 0 0 0 0 0 0 0 0 0 0 0 0 0 0 0 0 0 0 0 0 
0 1 1 1 1 1 x 0 x 0 x 0 x 0 x 0 x 0 x 0 2 2 2 2 0 
0 1 1 1 1 1 0 x 0 x 0 x 0 x 0 x 0 x 0 x 2 2 2 2 0 
0 5 5 5 5 5 x 0 x 0 x 0 x 0 x 0 x 0 x 0 6 6 6 6 0 
0 5 5 5 5 5 0 x 0 x 0 x 0 x 0 x 0 x 0 x 6 6 6 6 0 
x 0 x 0 x 0 x 0 x 0 x 0 x 0 x 0 x 0 x 0 x 0 x 0 x 
0 0 0 0 0 0 0 0 0 0 0 0 0 0 0 0 0 0 0 0 0 0 0 0 0 
0 0 0 0 0 0 0 0 0 0 0 0 0 0 0 0 0 0 0 0 0 0 0 0 0 
0 0 0 0 0 0 0 0 0 0 0 0 0 0 0 0 0 0 0 0 0 0 0 0 0 
0 0 0 0 0 0 0 0 0 0 0 0 0 0 0 0 0 0 0 0 0 0 0 0 0 
0 0 0 0 0 0 0 0 0 0 0 0 0 0 0 0 0 0 0 0 0 0 0 0 0 
0 0 0 0 0 0 0 0 0 0 0 0 0 0 0 0 0 0 0 0 0 0 0 0 0 
0 0 0 0 0 0 0 0 0 0 0 0 0 0 0 0 0 0 0 0 0 0 0 0 0 
0 0 0 0 0 0 0 0 0 0 0 0 0 0 0 0 0 0 0 0 0 0 0 0 0 
0 0 0 0 0 0 0 0 0 0 0 0 0 0 0 0 0 0 0 0 0 0 0 0 0 
0 0 0 0 0 0 0 0 0 0 0 0 0 0 0 0 0 0 0 0 0 0 0 0 0 
0 0 0 0 0 0 0 0 0 0 0 0 0 0 0 0 0 0 0 0 0 0 0 0 0 
0 0 0 0 0 0 0 0 0 0 0 0 0 0 0 0 0 0 0 0 0 0 0 0 0 
0 0 x 0 x 0 x 0 x 0 x 0 x 0 x 0 x 0 x 0 x 0 x 0 0 
0 4 4 4 4 4 x 0 x 0 x 0 x 0 x 0 x 0 x 0 3 3 3 3 0 
0 4 4 4 4 4 0 x 0 x 0 x 0 x 0 x 0 x 0 x 3 3 3 3 0 
0 8 8 8 8 8 x 0 x 0 x 0 x 0 x 0 x 0 x 0 7 7 7 7 0 
0 8 8 8 8 8 0 x 0 x 0 x 0 x 0 x 0 x 0 x 7 7 7 7 0 
0 0 0 0 0 0 0 0 0 0 0 0 0 0 0 0 0 0 0 0 0 0 0 0 0 
