8
1
1 2
50 50
0 0 0 0 0 0 0 0 0 - 0 0 0 0 0 0 0 0 0 0 - 0 0 0 b b 0 0 0 - 0 0 0 0 0 0 0 0 0 0 - 0 0 0 0 0 0 0 0 0
0 0 0 x 0 x 0 0 0 - 0 x x 0 0 0 0 x x 0 - 0 0 x 0 0 x 0 0 - 0 x x 0 0 0 0 x x 0 - 0 0 0 x 0 x 0 0 0
0 0 0 0 0 0 b x 0 - - 0 x 0 0 0 0 x 0 - - 0 0 0 - - 0 0 0 - - 0 x 0 0 0 0 x 0 - - 0 x b 0 0 0 0 0 0
0 x 0 x - - 0 0 0 0 0 0 0 0 - - 0 0 0 0 0 0 0 x 0 0 x 0 0 0 0 0 0 0 - - 0 0 0 0 0 0 0 0 - - x 0 x 0
0 0 0 - 1 1 0 0 - 0 x 0 0 0 - - 0 0 0 x 0 - 0 0 2 2 0 0 - 0 x 0 0 0 - - 0 0 0 x 0 - 0 0 3 3 - 0 0 0
0 x 0 - 1 1 0 0 - 0 0 0 0 0 - - 0 0 0 0 0 - 0 0 2 2 0 0 - 0 0 0 0 0 - - 0 0 0 0 0 - 0 0 3 3 - 0 x 0
0 0 b 0 0 0 x 0 x 0 x 0 0 0 - - 0 0 0 x 0 x 0 x 0 0 x 0 x 0 x 0 0 0 - - 0 0 0 x 0 x 0 x 0 0 0 b 0 0
0 0 x 0 0 0 0 0 0 - - 0 0 0 0 0 0 0 0 - - 0 0 0 - - 0 0 0 - - 0 0 0 0 0 0 0 0 - - 0 0 0 0 0 0 x 0 0
0 0 0 0 - - x 0 0 - - 0 x x 0 0 x x 0 - - 0 0 0 0 0 0 0 0 - - 0 x x 0 0 x x 0 - - 0 0 x - - 0 0 0 0
- - - 0 0 0 0 - - - - - - 0 x x 0 - - - - - - - - - - - - - - - - 0 x x 0 - - - - - - 0 0 0 0 - - -
0 0 - 0 x 0 x - - - 0 0 0 0 0 0 0 0 0 0 0 0 0 0 0 0 0 0 0 0 0 0 0 0 0 0 0 0 0 0 - - - x 0 x 0 - 0 0
0 x 0 0 0 0 0 0 0 - 0 0 0 0 x 0 x 0 0 0 0 0 0 0 0 0 0 0 0 0 0 0 0 x 0 x 0 0 0 0 - 0 0 0 0 0 0 0 x 0
0 x x 0 0 0 0 0 x - 0 0 0 0 0 0 0 0 x 0 x 0 0 0 0 0 0 0 0 x 0 x 0 0 0 0 0 0 0 0 - x 0 0 0 0 0 x x 0
0 0 0 0 0 0 0 0 0 0 0 0 0 0 x 0 0 0 0 0 0 0 x 0 0 0 0 x 0 0 0 0 0 0 0 x 0 0 0 0 0 0 0 0 0 0 0 0 0 0
0 0 0 - - - - 0 0 x 0 x 0 x 0 0 0 0 0 0 0 0 0 0 0 0 0 0 0 0 0 0 0 0 0 0 x 0 x 0 x 0 0 - - - - 0 0 0
0 0 0 - - - - 0 0 x 0 0 0 0 0 0 0 0 0 0 0 0 0 x 0 0 x 0 0 0 0 0 0 0 0 0 0 0 0 0 x 0 0 - - - - 0 0 0
0 0 0 0 0 0 0 0 0 0 0 x 0 0 0 0 0 0 0 0 0 0 0 0 0 0 0 0 0 0 0 0 0 0 0 0 0 0 x 0 0 0 0 0 0 0 0 0 0 0
0 x x 0 0 0 0 0 x - 0 0 0 0 0 0 0 0 0 0 0 0 0 x 0 0 x 0 0 0 0 0 0 0 0 0 0 0 0 0 - x 0 0 0 0 0 x x 0
0 x 0 0 0 0 0 0 0 - 0 0 x 0 0 0 0 0 0 0 0 0 0 0 0 0 0 0 0 0 0 0 0 0 0 0 0 x 0 0 - 0 0 0 0 0 0 0 x 0
0 0 - 0 x 0 x - - - 0 0 0 0 0 0 0 0 0 0 0 0 x 0 0 0 0 x 0 0 0 0 0 0 0 0 0 0 0 0 - - - x 0 x 0 - 0 0
- - - 0 0 0 0 - - - 0 0 x 0 0 0 0 0 0 0 0 b 0 0 0 0 0 0 b 0 0 0 0 0 0 0 0 x 0 0 - - - 0 0 0 0 - - -
0 0 0 0 - - x 0 0 - 0 0 0 0 0 0 0 0 0 0 b x b x 0 0 x b x b 0 0 0 0 0 0 0 0 0 0 - 0 0 x - - 0 0 0 0
0 0 0 0 0 0 0 0 0 - 0 0 0 x 0 0 0 0 0 x 0 b 0 0 0 0 0 0 b 0 x 0 0 0 0 0 x 0 0 0 - 0 0 0 0 0 0 0 0 0
0 x 0 x 0 0 x 0 0 - 0 0 0 0 0 x 0 x 0 0 0 x 0 x 0 0 x 0 x 0 0 0 x 0 x 0 0 0 0 0 - 0 0 x 0 0 x 0 x 0
b 0 - 0 4 4 0 - 0 - 0 0 0 0 0 0 0 0 0 0 0 0 0 0 c c 0 0 0 0 0 0 0 0 0 0 0 0 0 0 - 0 - 0 5 5 0 - 0 b
b 0 - 0 4 4 0 - 0 - 0 0 0 0 0 0 0 0 0 0 0 0 0 0 c c 0 0 0 0 0 0 0 0 0 0 0 0 0 0 - 0 - 0 5 5 0 - 0 b
0 x 0 x 0 0 x 0 0 - 0 0 0 0 0 x 0 x 0 0 0 x 0 x 0 0 x 0 x 0 0 0 x 0 x 0 0 0 0 0 - 0 0 x 0 0 x 0 x 0
0 0 0 0 0 0 0 0 0 - 0 0 0 x 0 0 0 0 0 x 0 b 0 0 0 0 0 0 b 0 x 0 0 0 0 0 x 0 0 0 - 0 0 0 0 0 0 0 0 0
0 0 0 0 - - x 0 0 - 0 0 0 0 0 0 0 0 0 0 b x b x 0 0 x b x b 0 0 0 0 0 0 0 0 0 0 - 0 0 x - - 0 0 0 0
- - - 0 0 0 0 - - - 0 0 x 0 0 0 0 0 0 0 0 b 0 0 0 0 0 0 b 0 0 0 0 0 0 0 0 x 0 0 - - - 0 0 0 0 - - -
0 0 - 0 x 0 x - - - 0 0 0 0 0 0 0 0 0 0 0 0 x 0 0 0 0 x 0 0 0 0 0 0 0 0 0 0 0 0 - - - x 0 x 0 - 0 0
0 x 0 0 0 0 0 0 0 - 0 0 x 0 0 0 0 0 0 0 0 0 0 0 0 0 0 0 0 0 0 0 0 0 0 0 0 x 0 0 - 0 0 0 0 0 0 0 x 0
0 x x 0 0 0 0 0 x - 0 0 0 0 0 0 0 0 0 0 0 0 0 x 0 0 x 0 0 0 0 0 0 0 0 0 0 0 0 0 - x 0 0 0 0 0 x x 0
0 0 0 0 0 0 0 0 0 0 0 x 0 0 0 0 0 0 0 0 0 0 0 0 0 0 0 0 0 0 0 0 0 0 0 0 0 0 x 0 0 0 0 0 0 0 0 0 0 0
0 0 0 - - - - 0 0 x 0 0 0 0 0 0 0 0 0 0 0 0 0 x 0 0 x 0 0 0 0 0 0 0 0 0 0 0 0 0 x 0 0 - - - - 0 0 0
0 0 0 - - - - 0 0 x 0 x 0 x 0 0 0 0 0 0 0 0 0 0 0 0 0 0 0 0 0 0 0 0 0 0 x 0 x 0 x 0 0 - - - - 0 0 0
0 0 0 0 0 0 0 0 0 0 0 0 0 0 x 0 0 0 0 0 0 0 x 0 0 0 0 x 0 0 0 0 0 0 0 x 0 0 0 0 0 0 0 0 0 0 0 0 0 0
0 x x 0 0 0 0 0 x - 0 0 0 0 0 0 0 0 x 0 x 0 0 0 0 0 0 0 0 x 0 x 0 0 0 0 0 0 0 0 - x 0 0 0 0 0 x x 0
0 x 0 0 0 0 0 0 0 - 0 0 0 0 x 0 x 0 0 0 0 0 0 0 0 0 0 0 0 0 0 0 0 x 0 x 0 0 0 0 - 0 0 0 0 0 0 0 x 0
0 0 - 0 x 0 x - - - 0 0 0 0 0 0 0 0 0 0 0 0 0 0 0 0 0 0 0 0 0 0 0 0 0 0 0 0 0 0 - - - x 0 x 0 - 0 0
- - - 0 0 0 0 - - - - - - 0 x x 0 - - - - - - - - - - - - - - - - 0 x x 0 - - - - - - 0 0 0 0 - - -
0 0 0 0 - - x 0 0 - - 0 x x 0 0 x x 0 - - 0 0 0 0 0 0 0 0 - - 0 x x 0 0 x x 0 - - 0 0 x - - 0 0 0 0
0 0 x 0 0 0 0 0 0 - - 0 0 0 0 0 0 0 0 - - 0 0 0 - - 0 0 0 - - 0 0 0 0 0 0 0 0 - - 0 0 0 0 0 0 x 0 0
0 0 b 0 0 0 x 0 x 0 x 0 0 0 - - 0 0 0 x 0 x 0 x 0 0 x 0 x 0 x 0 0 0 - - 0 0 0 x 0 x 0 x 0 0 0 b 0 0
0 x 0 - 6 6 0 0 - 0 0 0 0 0 - - 0 0 0 0 0 - 0 0 7 7 0 0 - 0 0 0 0 0 - - 0 0 0 0 0 - 0 0 8 8 - 0 x 0
0 0 0 - 6 6 0 0 - 0 x 0 0 0 - - 0 0 0 x 0 - 0 0 7 7 0 0 - 0 x 0 0 0 - - 0 0 0 x 0 - 0 0 8 8 - 0 0 0
0 x 0 x - - 0 0 0 0 0 0 0 0 - - 0 0 0 0 0 0 0 x 0 0 x 0 0 0 0 0 0 0 - - 0 0 0 0 0 0 0 0 - - x 0 x 0
0 0 0 0 0 0 b x 0 - - 0 x 0 0 0 0 x 0 - - 0 0 0 - - 0 0 0 - - 0 x 0 0 0 0 x 0 - - 0 x b 0 0 0 0 0 0
0 0 0 x 0 x 0 0 0 - 0 x x 0 0 0 0 x x 0 - 0 0 x 0 0 x 0 0 - 0 x x 0 0 0 0 x x 0 - 0 0 0 x 0 x 0 0 0
0 0 0 0 0 0 0 0 0 - 0 0 0 0 0 0 0 0 0 0 - 0 0 0 b b 0 0 0 - 0 0 0 0 0 0 0 0 0 0 - 0 0 0 0 0 0 0 0 0
