8
1
0 2
17 17
0 0 0 0 0 - 0 0 0 0 0 - 0 0 0 0 0 
0 1 7 8 0 - 0 2 8 1 0 - 0 3 1 2 0 
0 6 5 7 0 - 0 7 6 8 0 - 0 8 7 1 0 
0 8 6 1 0 - 0 1 7 2 0 - 0 2 8 3 0 
0 0 0 0 0 - 0 0 0 0 0 - 0 0 0 0 0 
- - - - - - - - - - - - - - - - - 
0 0 0 0 0 - 0 0 0 0 0 - 0 0 0 0 0 
0 4 2 3 0 - 0 b x b 0 - 0 5 3 4 0 
0 1 8 2 0 - 0 x i x 0 - 0 2 1 3 0 
0 3 1 4 0 - 0 b x b 0 - 0 4 2 5 0 
0 0 0 0 0 - 0 0 0 0 0 - 0 0 0 0 0 
- - - - - - - - - - - - - - - - - 
0 0 0 0 0 - 0 0 0 0 0 - 0 0 0 0 0 
0 6 4 5 0 - 0 7 5 6 0 - 0 8 6 7 0 
0 3 2 4 0 - 0 4 3 5 0 - 0 5 4 6 0 
0 5 3 6 0 - 0 6 4 7 0 - 0 7 5 8 0 
0 0 0 0 0 - 0 0 0 0 0 - 0 0 0 0 0 
4 6 1 <-> 6 4 5
4 4 3 <-> 6 6 7
10 10 3 <-> 12 12 7
10 12 1 <-> 12 10 5
6 12 7 <-> 4 10 3
4 12 1 <-> 6 10 5
10 6 1 <-> 12 4 5
10 4 3 <-> 12 6 7
4 0 1 <-> 6 16 5
4 16 3 <-> 6 0 7
10 0 1 <-> 12 16 5
10 16 3 <-> 12 0 7
16 0 1 <-> 0 16 5
16 16 3 <-> 0 0 7
0 6 7 <-> 16 4 3
16 6 1 <-> 0 4 5
0 10 5 <-> 16 12 1
16 10 3 <-> 0 12 7
