8
0
1 2
24 43
- - - - - - - - - - - - - - - - - - - - - - - - - - - - - - - - - - - - - - - - - - - 
- 0 0 0 - - - - - - - - 0 0 0 0 0 0 0 0 0 - - 0 0 0 0 0 0 0 0 0 - - 0 0 0 7 8 0 0 0 0 
- 0 i 0 - - - - - - - - 0 c 0 0 0 0 0 0 0 - - 0 c 0 0 0 5 6 0 0 - - 0 0 0 8 7 0 0 b 0 
- 0 0 0 - - - - - - - - 0 0 0 0 0 0 0 0 0 - - 0 0 0 0 0 6 5 0 0 - - 0 0 0 0 0 0 0 0 0 
- 0 0 0 - - - - - - - - - - - - - - 0 0 0 - - - - - - - - 0 0 0 - - - - - 0 0 0 - - - 
- 0 0 0 - - - - - - - - 0 3 4 0 0 8 7 0 0 - - 0 0 0 0 0 0 0 0 0 - - - - - 0 0 0 - - - 
- 0 0 0 - - - - - - - - 0 4 3 0 0 7 8 b 0 - - 0 0 5 6 0 0 0 b 0 - - - - - 0 0 0 - - - 
- 0 0 0 - - - - - - - - 0 0 0 0 0 0 0 0 0 - - 0 0 6 5 0 0 0 0 0 - - - - - 0 0 0 - - - 
- 0 0 0 - - - - - - - - - - - - - - 0 0 0 - - - - - - - - 0 0 0 - - - - - 0 0 0 - - - 
- 0 1 2 0 0 0 0 0 0 - - 0 0 0 0 0 0 0 0 0 - - 0 0 0 0 0 0 0 0 0 - - - - - 0 0 0 - - - 
- 0 2 1 0 0 0 0 b 0 - - 0 0 0 0 0 0 0 0 0 - - 0 0 0 0 0 0 0 0 0 - - - - - 0 i 0 - - - 
- 0 0 0 0 0 0 0 0 0 - - 0 0 0 0 0 0 0 0 0 - - 0 0 0 0 0 0 0 0 0 - - - - - 0 0 0 - - - 
- - - - - - - - - - - - - - - - - - - - - - - - - - - - - - - - - - - - - - - - - - - 
- - - - - - 0 0 0 0 - - 0 0 0 0 0 0 0 0 0 - - 0 0 0 0 0 0 0 0 0 - - 0 0 0 0 0 0 0 0 0 
- - - - - 0 0 0 i 0 - - 0 0 0 0 0 4 3 0 0 - - 0 0 0 0 0 1 2 0 0 - - 0 b 0 0 0 0 2 1 0 
- - - - 0 0 0 0 0 0 - - 0 0 0 0 0 3 4 0 0 - - 0 0 0 0 0 2 1 0 0 - - 0 0 0 0 0 0 1 2 0 
- - - 0 0 0 - 0 0 0 - - - - - - - - 0 0 0 - - - - - - - - 0 0 0 - - - - - - - 0 0 0 0 
- - 0 0 0 - - 0 0 0 - - 0 0 0 0 0 0 0 0 0 - - 0 3 4 0 0 0 0 0 0 - - - - - - - 0 0 0 0 
- 0 b 0 - - - 0 0 0 - - 0 0 5 6 0 0 0 b 0 - - 0 4 3 0 0 0 0 b 0 - - - - - - 0 0 0 0 - 
- 0 0 0 - - - 0 0 0 - - 0 0 6 5 0 0 0 0 0 - - 0 0 0 0 0 0 0 0 0 - - - - - 0 0 0 0 - - 
- - - - - - - 0 7 8 - - - - - - - - 0 0 0 - - - - - - - - 0 0 0 - - - - 0 0 0 0 - - - 
- - - - - - - 0 8 7 - - 0 0 0 0 0 0 0 0 0 - - 0 0 0 0 0 0 0 0 0 - - - 0 0 0 0 - - - - 
- - - - - - - 0 0 0 - - 0 c 0 0 0 0 0 0 0 - - 0 c 0 0 0 0 0 0 0 - - 0 i 0 0 - - - - - 
- - - - - - - 0 0 0 - - 0 0 0 0 0 0 0 0 0 - - 0 0 0 0 0 0 0 0 0 - - 0 0 0 - - - - - - 
9 10 2 <-> 12 10 6
20 10 2 <-> 23 10 6
20 2 2 <-> 23 2 6
20 6 2 <-> 23 6 6
31 2 2 <-> 34 2 6
9 22 2 <-> 12 22 6
9 18 2 <-> 12 18 6
9 14 2 <-> 12 14 6
20 14 2 <-> 23 14 6
20 18 2 <-> 23 18 6
20 22 2 <-> 23 22 6
31 14 2 <-> 34 14 6
31 22 2 <-> 34 22 6
38 13 0 <-> 38 11 4
30 11 4 <-> 30 13 0
19 11 4 <-> 19 13 0
8 11 4 <-> 8 13 0
2 19 4 <-> 2 1 0
42 2 2 <-> 1 2 6
41 3 4 <-> 41 13 0
35 3 4 <-> 35 13 0
35 15 4 <-> 35 21 0
27 21 0 <-> 27 19 4
27 15 4 <-> 27 17 0
16 15 4 <-> 16 17 0
16 19 4 <-> 16 21 0
4 17 2 <-> 7 17 6
27 9 0 <-> 27 7 4
27 5 0 <-> 27 3 4
16 5 0 <-> 16 3 4
16 9 0 <-> 16 7 4
8 9 0 <-> 8 23 4
16 23 4 <-> 16 1 0
27 23 4 <-> 27 1 0
