8
1
1 3
47 49
0 0 0 0 0 0 0 - 0 0 0 0 0 0 0 0 0 0 - 0 0 0 0 0 0 0 0 0 0 0 0 0 0 - 0 0 0 0 0 0 0 0 0 0 0 0 0 - 0 
0 0 0 0 0 0 0 - 0 0 0 0 0 0 0 0 0 0 - 0 0 0 0 0 0 0 0 0 0 0 0 0 0 - 0 0 0 0 0 0 0 0 0 0 0 0 0 - 0 
0 0 0 c 0 0 0 - 0 0 0 0 0 c 0 0 0 0 - 0 0 0 0 0 0 0 c 0 0 0 0 0 0 - 0 0 0 0 0 0 0 c 0 0 0 0 0 - 0 
0 0 0 0 0 0 0 - 0 0 0 0 0 0 0 0 0 0 - 0 0 0 0 0 0 0 0 0 0 0 0 0 0 - 0 0 0 0 0 0 0 0 0 0 0 0 0 - 0 
0 0 0 0 0 0 0 - 0 0 0 0 0 0 0 0 0 0 - 0 0 0 0 0 0 0 0 0 0 0 0 0 0 - 0 0 0 0 0 0 0 0 0 0 0 0 0 - 0 
0 0 0 0 0 0 0 - 0 0 0 0 0 0 0 0 0 0 - 0 0 0 0 0 0 0 0 0 0 0 0 0 0 - 0 0 0 0 0 0 0 0 0 0 0 0 0 - 0 
0 0 0 0 0 0 0 - 0 0 0 0 0 0 0 0 0 0 - 0 0 0 0 0 0 0 0 0 0 0 0 0 0 - 0 0 0 0 0 0 0 0 0 0 0 0 0 - 0 
0 0 0 0 0 0 0 - 0 0 0 0 0 0 0 0 0 0 - 0 0 0 0 0 0 0 0 0 0 0 0 0 0 - 0 0 0 0 0 0 0 0 0 0 0 0 0 - 0 
0 0 0 0 0 0 0 - 0 0 0 0 0 0 0 0 0 0 - 0 0 0 0 0 0 0 0 0 0 0 0 0 0 - 0 0 0 0 0 0 0 0 0 0 0 0 0 - 0 
0 0 0 0 0 0 0 - 0 0 0 0 0 0 0 0 0 0 - 0 0 0 0 0 0 0 0 0 0 0 0 0 0 - 0 0 0 0 0 0 0 0 0 0 0 0 0 - 0 
0 0 0 0 0 0 0 - 0 0 0 0 0 0 0 0 0 0 - 0 0 0 0 0 0 0 0 0 0 0 0 0 0 - 0 0 0 0 0 0 0 0 0 0 0 0 0 - 0 
0 0 0 0 0 0 0 - 0 0 0 1 5 0 0 0 0 0 - 0 0 0 0 0 0 0 0 0 0 0 0 0 0 - 0 0 0 0 0 0 0 0 0 0 0 0 0 - 0 
0 0 0 0 0 0 0 - 0 0 0 5 1 0 0 0 0 0 - 0 0 0 0 0 0 0 0 0 0 0 0 0 0 - 0 0 0 0 0 0 0 0 0 0 0 0 0 - 0 
0 0 0 0 0 0 0 - 0 0 0 0 0 0 0 0 0 0 - 0 0 0 0 0 0 0 0 0 0 0 0 0 0 - 0 0 0 0 0 0 0 0 0 0 0 0 0 - 0 
0 0 0 0 0 0 0 - 0 0 0 0 0 0 0 0 0 0 - 0 0 0 0 0 0 0 0 0 0 0 0 0 0 - 0 0 0 0 0 0 0 0 0 0 0 0 0 - 0 
0 0 0 0 0 0 0 - 0 0 0 0 0 0 0 0 0 0 - 0 0 0 0 0 0 0 0 0 0 0 0 0 0 0 0 0 0 0 0 0 0 0 0 0 0 0 0 - 0 
0 0 0 0 0 0 0 0 0 0 0 0 0 0 0 0 0 0 - 0 0 0 0 0 0 0 0 0 0 0 0 0 0 0 0 0 0 0 0 0 0 0 0 0 0 0 0 - 0 
0 0 0 0 0 0 0 0 0 0 0 2 6 0 0 0 0 0 - 0 0 0 0 0 0 0 0 0 0 0 0 0 0 0 0 0 0 0 0 0 0 0 0 0 0 0 0 - 0 
0 0 0 0 0 0 0 0 0 0 0 6 2 0 0 0 0 0 - 0 0 0 0 0 0 0 0 0 0 0 0 0 0 0 0 0 0 0 0 0 0 0 0 0 0 0 0 - 0 
0 0 0 0 0 0 0 0 0 0 0 0 0 0 0 0 0 0 - 0 0 0 0 0 0 1 2 3 4 5 6 7 8 0 0 0 0 0 0 0 0 0 0 0 0 0 0 - 0 
0 0 0 0 0 0 0 0 0 0 0 0 0 0 0 0 0 0 - 0 0 0 0 0 0 8 1 2 3 4 5 6 7 0 0 0 0 0 0 0 0 0 0 0 0 0 0 - 0 
0 0 0 0 0 0 0 0 0 0 0 0 0 0 0 0 0 0 - 0 0 0 0 0 0 7 8 1 2 3 4 5 6 0 0 0 0 0 0 0 0 0 0 0 0 0 0 - 0 
0 0 0 0 0 0 0 0 0 0 0 0 0 0 0 0 0 0 - 0 0 0 0 0 0 6 7 8 1 2 3 4 5 0 0 0 0 0 0 0 0 0 0 0 0 0 0 - 0 
0 0 0 0 0 0 0 0 0 0 0 0 0 0 0 0 0 0 - 0 0 0 0 0 0 5 6 7 8 1 2 3 4 0 0 0 0 0 0 0 0 0 0 0 0 0 0 - 0 
0 0 0 0 0 0 0 0 0 0 0 3 7 0 0 0 0 0 - 0 0 0 0 0 0 4 5 6 7 8 1 2 3 0 0 0 0 0 0 0 0 0 0 0 0 0 0 - 0 
0 0 0 0 0 0 0 0 0 0 0 7 3 0 0 0 0 0 - 0 0 0 0 0 0 3 4 5 6 7 8 1 2 0 0 0 0 0 0 0 0 - 0 0 0 0 0 - 0 
0 0 0 0 0 0 0 0 0 0 0 0 0 0 0 0 0 0 - 0 0 0 0 0 0 2 3 4 5 6 7 8 1 0 0 0 0 0 0 0 0 - 0 0 0 0 0 - 0 
0 0 0 0 0 0 0 0 0 0 0 0 0 0 0 0 0 0 - 0 0 0 0 0 0 0 0 0 0 0 0 0 0 0 0 0 0 0 0 0 0 - 0 0 0 0 0 0 0 
0 0 - 0 0 0 0 0 0 0 0 0 0 0 0 0 0 0 - 0 0 0 0 0 0 0 0 0 0 0 0 0 0 0 0 0 0 0 0 0 0 - 0 0 0 0 0 0 0 
0 0 - 0 0 0 0 0 0 0 0 0 0 0 0 0 0 0 - 0 0 0 0 0 0 0 0 0 0 0 0 0 0 0 0 0 0 0 0 0 0 - 0 0 0 0 0 0 0 
0 0 - 0 0 0 0 0 0 0 0 4 8 0 0 0 0 0 - 0 0 0 0 0 0 0 0 0 0 0 0 0 0 0 0 0 0 0 0 0 0 - 0 0 0 0 0 0 0 
0 0 - 0 0 0 0 0 0 0 0 8 4 0 0 0 0 0 - 0 0 0 0 0 0 0 0 0 0 0 0 0 0 0 0 0 0 0 0 0 0 - 0 0 0 0 0 0 0 
0 0 - 0 0 0 0 0 0 0 0 0 0 0 0 0 0 0 - 0 0 0 0 0 0 0 0 0 0 0 0 0 0 0 0 0 0 0 0 0 0 - 0 0 0 0 0 0 0 
0 0 - 0 0 0 0 0 0 0 0 0 0 0 0 0 0 0 - 0 0 0 0 0 0 0 - 0 0 0 0 0 0 0 0 0 0 0 0 0 0 - 0 0 0 0 0 0 0 
0 0 - 0 0 0 0 0 0 0 0 0 0 0 0 0 0 0 - 0 0 0 0 0 0 0 - 0 0 0 0 0 0 0 0 0 0 0 0 0 0 - 0 0 0 0 0 0 0 
0 0 - 0 0 0 0 0 0 0 0 - 0 0 0 0 0 0 - 0 0 0 0 0 0 0 - 0 0 0 0 0 0 0 0 0 0 0 0 0 0 - 0 0 0 0 0 0 0 
0 0 - 0 0 0 0 0 0 0 0 - 0 0 0 0 0 0 0 0 0 0 0 0 0 0 - 0 0 0 0 0 0 0 0 0 0 0 0 0 0 - 0 0 0 0 0 0 0 
0 0 - 0 0 0 0 0 0 0 0 - 0 0 0 0 0 0 0 0 0 0 0 0 0 0 - 0 0 0 0 0 0 0 0 0 0 0 0 0 0 - 0 0 0 0 0 0 0 
0 0 - 0 0 0 0 0 0 0 0 - 0 0 0 0 0 0 0 0 0 0 0 0 0 0 - 0 0 0 0 0 0 0 0 0 0 0 0 0 0 - 0 0 0 0 0 0 0 
0 0 - 0 0 0 0 0 0 0 0 - 0 0 0 0 0 0 0 0 0 0 0 0 0 0 - 0 0 0 0 0 0 0 0 0 0 0 0 0 0 - 0 0 0 0 0 0 0 
0 0 - 0 0 0 0 0 0 0 0 - 0 0 0 0 0 0 0 0 0 0 0 0 0 0 - 0 0 0 0 0 0 0 0 0 0 0 0 0 0 - 0 0 0 0 0 0 0 
0 0 - 0 0 0 0 0 0 0 0 - 0 0 0 0 0 0 0 0 0 0 0 0 0 0 - 0 0 0 0 0 0 0 0 0 0 0 0 0 0 - 0 0 0 0 0 0 0 
0 0 - 0 0 0 b 0 0 0 0 - 0 0 0 0 0 0 0 b 0 0 0 0 0 0 - 0 0 0 0 0 0 0 b 0 0 0 0 0 0 - 0 0 0 b 0 0 0 
0 0 - 0 0 0 0 0 0 0 0 - 0 0 0 0 0 0 0 0 0 0 0 0 0 0 - 0 0 0 0 0 0 0 0 0 0 0 0 0 0 - 0 0 0 0 0 0 0 
0 0 - 0 0 0 0 0 0 0 0 - 0 0 0 0 0 0 0 0 0 0 0 0 0 0 - 0 0 0 0 0 0 0 0 0 0 0 0 0 0 - 0 0 0 0 0 0 0 
0 0 - 0 0 0 0 0 0 0 0 - 0 0 0 0 0 0 0 0 0 0 0 0 0 0 - 0 0 0 0 0 0 0 0 0 0 0 0 0 0 - 0 0 0 0 0 0 0 
0 0 - 0 0 0 0 0 0 0 0 - 0 0 0 0 0 0 0 0 0 0 0 0 0 0 - 0 0 0 0 0 0 0 0 0 0 0 0 0 0 - 0 0 0 0 0 0 0 
0 0 6 <-> 48 0 2
0 1 6 <-> 48 1 2
0 2 6 <-> 48 2 2
0 3 6 <-> 48 3 2
0 4 6 <-> 48 4 2
0 5 6 <-> 48 5 2
0 6 6 <-> 48 6 2
0 7 6 <-> 48 7 2
0 8 6 <-> 48 8 2
0 9 6 <-> 48 9 2
0 10 6 <-> 48 10 2
0 11 6 <-> 48 11 2
0 12 6 <-> 48 12 2
0 13 6 <-> 48 13 2
0 14 6 <-> 48 14 2
0 15 6 <-> 48 15 2
0 16 6 <-> 48 16 2
0 17 6 <-> 48 17 2
0 18 6 <-> 48 18 2
0 19 6 <-> 48 19 2
0 20 6 <-> 48 20 2
0 21 6 <-> 48 21 2
0 22 6 <-> 48 22 2
0 23 6 <-> 48 23 2
0 24 6 <-> 48 24 2
0 25 6 <-> 48 25 2
0 26 6 <-> 48 26 2
0 28 6 <-> 48 28 2
0 27 6 <-> 48 27 2
0 29 6 <-> 48 29 2
0 30 6 <-> 48 30 2
0 31 6 <-> 48 31 2
0 32 6 <-> 48 32 2
0 33 6 <-> 48 33 2
0 34 6 <-> 48 34 2
0 35 6 <-> 48 35 2
0 36 6 <-> 48 36 2
0 37 6 <-> 48 37 2
0 38 6 <-> 48 38 2
0 39 6 <-> 48 39 2
0 40 6 <-> 48 40 2
0 41 6 <-> 48 41 2
0 42 6 <-> 48 42 2
0 43 6 <-> 48 43 2
0 44 6 <-> 48 44 2
0 45 6 <-> 48 45 2
0 46 6 <-> 48 46 2
