8
2
1 1
35 41
- - - - - - - - - - - - - - - - - 0 0 0 0 0 0 0 0 0 0 0 0 0 - - - - - - - - - - - 
- - - - - - - - - - - - - - - - 0 0 0 0 0 0 0 0 0 0 0 0 0 0 0 - - - - - - - - - - 
- - - - - - - - - - - - - - - 0 0 0 0 0 0 0 0 0 0 0 0 0 0 0 0 0 - - - - - - - - - 
- - - - - - - - - - - - - - 0 0 0 0 0 0 0 0 0 b 0 0 0 0 0 0 0 0 0 - - - - - - - - 
- - - - - - - - - - - - - 0 0 0 0 0 0 0 0 0 0 0 0 0 0 0 0 0 0 0 0 0 - - - - - - - 
- - - - - - - - - - - - 0 0 0 0 0 0 0 0 0 0 0 0 0 0 0 0 0 0 0 0 0 0 0 - - - - - - 
- - - - - - - - - - - 0 0 0 0 0 0 0 0 0 0 0 0 0 0 0 0 0 0 0 0 0 0 0 0 0 - - - - - 
- - - - - - - - - - 0 0 0 0 0 0 0 0 0 0 0 0 0 0 0 0 0 0 0 0 0 0 0 0 0 0 0 - - - - 
- - - - - - - - - 0 0 0 0 0 - - - - - - - - - - - - - - - - - - - 0 0 0 0 0 - - - 
- - - - - - - - 0 0 0 0 0 0 - - - 0 0 0 0 - - - - - 0 0 0 0 - - - 0 0 0 0 0 0 - - 
- - - - - - - 0 0 0 0 0 0 0 - - 0 0 0 0 0 0 - - - 0 0 0 0 0 0 - - 0 0 0 0 0 0 0 - 
- - - - - - 0 0 0 0 0 0 0 0 - 0 0 0 0 0 0 0 0 - 0 0 0 0 0 0 0 0 - 0 0 0 0 0 0 0 0 
- - - - - - 0 0 0 0 0 0 0 0 - 0 0 0 1 2 0 0 0 - 0 0 0 3 4 0 0 0 - 0 0 0 0 0 0 0 0 
- - - - - - 0 0 0 0 0 0 0 0 - 0 0 0 2 1 0 0 0 - 0 0 0 4 3 0 0 0 - 0 0 0 0 0 0 0 0 
- - - - - - 0 0 0 0 0 0 0 0 - 0 0 0 0 0 0 0 0 - 0 0 0 0 0 0 0 0 - 0 0 0 0 0 0 0 0 
- - - - - - 0 0 0 0 0 0 0 0 - - 0 0 0 0 0 0 - - - 0 0 0 0 0 0 - - 0 0 0 0 0 0 0 0 
- - - - - - 0 0 0 0 0 0 0 0 - - - 0 0 0 0 - - - - - 0 0 0 0 - - - 0 0 0 0 0 0 0 0 
- - - - - - 0 0 0 b 0 0 0 0 - - - - - - - - - - - - - - - - - - - 0 0 0 0 b 0 0 0 
- - - - - - 0 0 0 0 0 0 0 0 - - - 0 0 0 0 - - - - - 0 0 0 0 - - - 0 0 0 0 0 0 0 0 
- - - - - - 0 0 0 0 0 0 0 0 - - 0 0 0 0 0 0 - - - 0 0 0 0 0 0 - - 0 0 0 0 0 0 0 0 
- - - - - - 0 0 0 0 0 0 0 0 - 0 0 0 0 0 0 0 0 - 0 0 0 0 0 0 0 0 - 0 0 0 0 0 0 0 0 
- - - - - - 0 0 0 0 0 0 0 0 - 0 0 0 5 6 0 0 0 - 0 0 0 8 7 0 0 0 - 0 0 0 0 0 0 0 0 
- - - - - - 0 0 0 0 0 0 0 0 - 0 0 0 6 5 0 0 0 - 0 0 0 7 8 0 0 0 - 0 0 0 0 0 0 0 0 
- - - - - - 0 0 0 0 0 0 0 0 - 0 0 0 0 0 0 0 0 - 0 0 0 0 0 0 0 0 - 0 0 0 0 0 0 0 0 
- - - - - - - 0 0 0 0 0 0 0 - - 0 0 0 0 0 0 - - - 0 0 0 0 0 0 - - 0 0 0 0 0 0 0 - 
- - - - - - - - 0 0 0 0 0 0 - - - 0 0 0 0 - - - - - 0 0 0 0 - - - 0 0 0 0 0 0 - - 
- - - - - - - - - 0 0 0 0 0 - - - - - - - - - - - - - - - - - - - 0 0 0 0 0 - - - 
- - - - - - - - - - 0 0 0 0 0 0 0 0 0 0 0 0 0 0 0 0 0 0 0 0 0 0 0 0 0 0 0 - - - - 
- - - - - - - - - - - 0 0 0 0 0 0 0 0 0 0 0 0 0 0 0 0 0 0 0 0 0 0 0 0 0 - - - - - 
- - - - - - - - - - - - 0 0 0 0 0 0 0 0 0 0 0 0 0 0 0 0 0 0 0 0 0 0 0 - - - - - - 
- - - - - - - - - - - - - 0 0 0 0 0 0 0 0 0 0 0 0 0 0 0 0 0 0 0 0 0 - - - - - - - 
- - - - - - - - - - - - - - 0 0 0 0 0 0 0 0 0 b 0 0 0 0 0 0 0 0 0 - - - - - - - - 
- - - - - - - - - - - - - - - 0 0 0 0 0 0 0 0 0 0 0 0 0 0 0 0 0 - - - - - - - - - 
- - - - - - - - - - - - - - - - 0 0 0 0 0 0 0 0 0 0 0 0 0 0 0 - - - - - - - - - - 
- - - - - - - - - - - - - - - - - 0 0 0 0 0 0 0 0 0 0 0 0 0 - - - - - - - - - - - 
29 9 0 <-> 29 7 4
17 7 4 <-> 17 9 0
33 11 6 <-> 31 11 2
31 23 2 <-> 33 23 6
29 27 0 <-> 29 25 4
17 27 0 <-> 17 25 4
13 23 2 <-> 15 23 6
13 11 2 <-> 15 11 6
22 12 2 <-> 24 12 6
22 13 2 <-> 24 13 6
22 21 2 <-> 24 21 6
22 22 2 <-> 24 22 6
19 16 4 <-> 19 18 0
18 16 4 <-> 18 18 0
27 16 4 <-> 27 18 0
28 16 4 <-> 28 18 0
24 7 3 <-> 26 9 7
20 9 1 <-> 22 7 5
20 25 3 <-> 22 27 7
26 25 5 <-> 24 27 1
31 14 3 <-> 33 16 7
31 20 1 <-> 33 18 5
15 14 5 <-> 13 16 1
15 20 7 <-> 13 18 3
31 12 2 <-> 33 12 6
31 13 2 <-> 33 13 6
13 12 2 <-> 15 12 6
13 13 2 <-> 15 13 6
28 27 0 <-> 28 25 4
27 27 0 <-> 27 25 4
18 27 0 <-> 18 25 4
19 27 0 <-> 19 25 4
13 22 2 <-> 15 22 6
13 21 2 <-> 15 21 6
18 7 4 <-> 18 9 0
19 7 4 <-> 19 9 0
28 7 4 <-> 28 9 0
31 22 2 <-> 33 22 6
31 21 2 <-> 33 21 6
27 7 4 <-> 27 9 0
