8
1
1 2
19 48
- - - - - - - - - - - - - - - - - - - - - - - - - - - - - - - - - - - - - - - - - - - - - - - - 
- - - - - - - - 0 0 0 0 0 0 0 0 0 - - - - - - - - - - - - - - - - - - - - - - - - - - - - - - - 
- - - - 0 0 0 0 0 0 0 0 0 0 0 0 0 0 0 0 0 - - - - - - - - - - - - - - - - - - - - - - - - - - - 
- - - 0 0 0 0 0 0 - - - - - - - 0 0 0 0 0 0 - - - - - - - - - 0 0 0 0 0 0 0 0 0 - - - - - - - - 
- - 0 0 - - - - - - - - - - - - - - - - - 0 0 - - - - 0 0 0 0 0 0 0 0 0 0 0 0 0 0 0 0 0 - - - - 
- - 0 - - - - - - - - - - - - - - - - - - - 0 - - - 0 0 0 0 0 0 - - - - - - - 0 0 0 0 0 0 - - - 
- - - - - - - - - - - - - - - - - - - - - - - - - 0 0 - - - - - - - - - - - - - - - - - 0 0 - - 
- - - - - - - - - 0 0 0 c 0 0 0 - - - - - - - - - 0 - - - - - - 0 0 0 c 0 0 0 - - - - - - 0 - - 
- - - - - - - b 0 0 0 0 0 0 0 0 0 b - - - - - - - - - - - - b 0 0 0 0 0 0 0 0 0 b - - - - - - - 
- - - - - b 0 0 0 0 x x x x x 0 0 0 0 b - - - - - - - - b 0 0 0 0 x x x x x 0 0 0 0 b - - - - - 
- - - - 0 0 0 0 0 x 0 0 0 0 0 x 0 0 0 0 0 - - - - - - 0 0 0 0 0 x 0 0 0 0 0 x 0 0 0 0 0 - - - - 
- - - 0 0 0 0 0 x 0 0 2 3 1 0 0 x 0 0 0 0 0 - - - - 0 0 0 0 0 x 0 0 5 6 7 0 0 x 0 0 0 0 0 - - - 
- - 0 0 0 0 0 x 0 0 4 1 2 3 4 0 0 x 0 0 0 0 0 - - 0 0 0 0 0 x 0 0 8 7 5 6 8 0 0 x 0 0 0 0 0 - - 
- - - 0 0 0 0 0 x 0 0 3 1 2 0 0 x 0 0 0 0 0 - - - - 0 0 0 0 0 x 0 0 6 7 5 0 0 x 0 0 0 0 0 - - - 
- - - - 0 0 0 0 0 x 0 0 4 0 0 x 0 0 0 0 0 - - - - - - 0 0 0 0 0 x 0 0 8 0 0 x 0 0 0 0 0 - - - - 
- - - - - 0 0 0 0 0 x 0 0 0 x 0 0 0 0 0 - - - - - - - - 0 0 0 0 0 x 0 0 0 x 0 0 0 0 0 - - - - - 
- - - - - - - 0 0 0 0 x x x 0 0 0 0 - - - - - - - - - - - - 0 0 0 0 x x x 0 0 0 0 - - - - - - - 
- - - - - - - - - 0 0 0 0 0 0 0 - - - - - - - - - - - - - - - - 0 0 0 0 0 0 0 - - - - - - - - - 
- - - - - - - - - - - - - - - - - - - - - - - - - - - - - - - - - - - - - - - - - - - - - - - - 
4 10 0 <-> 4 3 4
20 10 0 <-> 20 3 4
10 7 0 <-> 10 2 4
14 7 0 <-> 14 2 4
2 12 0 <-> 2 5 4
22 12 0 <-> 22 5 4
33 7 0 <-> 33 4 4
37 7 0 <-> 37 4 4
45 12 0 <-> 45 7 4
43 10 0 <-> 43 5 4
25 12 0 <-> 25 7 4
27 10 0 <-> 27 5 4
15 17 2 <-> 32 17 6
17 16 2 <-> 30 16 6
19 15 2 <-> 28 15 6
20 14 2 <-> 27 14 6
21 13 2 <-> 26 13 6
9 17 6 <-> 38 17 2
7 16 6 <-> 40 16 2
5 15 6 <-> 42 15 2
4 14 6 <-> 43 14 2
3 13 6 <-> 44 13 2
35 17 4 <-> 12 1 0
12 17 4 <-> 35 3 0
