8
10
0 1
22 24
- - - b 0 0 0 - - - - - - - - - - b 0 0 0 - - - 
- - 0 0 0 0 0 0 - - - - - - - - 0 0 0 0 0 0 - - 
- 0 0 0 0 0 0 0 0 - - - - - - 0 0 0 0 0 0 0 0 - 
0 0 0 0 0 0 0 0 0 0 - - - - 0 0 0 0 0 0 0 0 0 0 
0 0 0 0 2 1 0 0 0 0 - - - - 0 0 0 0 3 4 0 0 0 0 
0 0 0 0 1 2 0 0 0 0 - - - - 0 0 0 0 4 3 0 0 0 0 
0 0 0 0 0 0 0 0 0 0 - - - - 0 0 0 0 0 0 0 0 0 0 
- 0 0 0 0 0 0 0 0 - - - - - - 0 0 0 0 0 0 0 0 - 
- - 0 0 0 0 0 0 - - - - - - - - 0 0 0 0 0 0 - - 
- - - 0 0 0 c - - - - - - - - - - 0 0 0 c - - - 
- - - - - - - - - - - - - - - - - - - - - - - - 
- - - - - - - - - - - - - - - - - - - - - - - - 
- - - 0 0 0 b - - - - - - - - - - 0 0 0 b - - - 
- - 0 0 0 0 0 0 - - - - - - - - 0 0 0 0 0 0 - - 
- 0 0 0 0 0 0 0 0 - - - - - - 0 0 0 0 0 0 0 0 - 
0 0 0 0 0 0 0 0 0 0 - - - - 0 0 0 0 0 0 0 0 0 0 
0 0 0 0 7 8 0 0 0 0 - - - - 0 0 0 0 5 6 0 0 0 0 
0 0 0 0 8 7 0 0 0 0 - - - - 0 0 0 0 6 5 0 0 0 0 
0 0 0 0 0 0 0 0 0 0 - - - - 0 0 0 0 0 0 0 0 0 0 
- 0 0 0 0 0 0 0 0 - - - - - - 0 0 0 0 0 0 0 0 - 
- - 0 0 0 0 0 0 - - - - - - - - 0 0 0 0 0 0 - - 
- - - c 0 0 0 - - - - - - - - - - c 0 0 0 - - - 
7 8 3 <-> 15 14 7
8 7 2 <-> 15 7 6
16 8 5 <-> 8 14 1
7 13 2 <-> 16 13 6
7 20 3 <-> 7 1 1
8 19 2 <-> 21 8 2
15 19 6 <-> 2 8 6
16 20 4 <-> 2 20 4
1 19 5 <-> 2 1 6
21 20 4 <-> 22 7 3
22 19 2 <-> 22 2 1
22 14 1 <-> 8 2 2
21 13 1 <-> 2 13 7
1 14 6 <-> 1 2 6
15 2 6 <-> 1 7 6
16 1 7 <-> 2 1 7
21 1 1 <-> 16 1 6
