8
3
3 2
50 50
0 0 0 0 0 0 0 0 0 0 - - - - - - - - - - 0 0 0 0 0 0 0 0 0 0 - - - - - - - - - - 0 0 0 0 0 0 0 0 0 0 
0 0 0 0 0 0 0 0 0 0 - - - - - - - - - - 0 0 0 0 0 0 0 0 0 0 - - - - - - - - - - 0 0 0 0 0 0 0 0 0 0 
0 0 0 0 0 0 0 0 0 0 - - - - - - - - - - 0 0 0 0 0 0 0 0 0 0 - - - - - - - - - - 0 0 0 0 0 0 0 0 0 0 
0 0 0 0 0 0 0 0 0 0 - - - - - - - - - - 0 0 0 0 i b 0 0 0 0 - - - - - - - - - - 0 0 0 0 0 0 0 0 0 0 
0 0 0 0 1 2 0 0 0 0 - - - - - - - - - - 0 0 0 0 b c 0 0 0 0 - - - - - - - - - - 0 0 0 0 4 3 0 0 0 0 
0 0 0 0 2 1 0 0 0 0 - - - - - - - - - - 0 0 0 0 c i 0 0 0 0 - - - - - - - - - - 0 0 0 0 3 4 0 0 0 0 
0 0 0 0 0 0 0 0 0 0 - - - - - - - - - - 0 0 0 0 0 0 0 0 0 0 - - - - - - - - - - 0 0 0 0 0 0 0 0 0 0 
0 0 0 0 0 0 0 0 0 0 - - - - - - - - - - 0 0 0 0 0 0 0 0 0 0 - - - - - - - - - - 0 0 0 0 0 0 0 0 0 0 
0 0 0 0 0 0 0 0 0 0 - - - - - - - - - - 0 0 0 0 0 0 0 0 0 0 - - - - - - - - - - 0 0 0 0 0 0 0 0 0 0 
0 0 0 0 0 0 0 0 0 0 - - - - - - - - - - 0 0 0 0 0 0 0 0 0 0 - - - - - - - - - - 0 0 0 0 0 0 0 0 0 0 
- - - - - - - - - - 0 0 0 0 0 0 0 0 0 0 - - - - - - - - - - 0 0 0 0 0 0 0 0 0 0 - - - - - - - - - - 
- - - - - - - - - - 0 0 0 0 0 0 0 0 0 0 - - - - - - - - - - 0 0 0 0 0 0 0 0 0 0 - - - - - - - - - - 
- - - - - - - - - - 0 0 0 0 0 0 0 0 0 0 - - - - - - - - - - 0 0 0 0 0 0 0 0 0 0 - - - - - - - - - - 
- - - - - - - - - - 0 0 0 0 0 0 0 0 0 0 - - - - - - - - - - 0 0 0 0 0 0 0 0 0 0 - - - - - - - - - - 
- - - - - - - - - - 0 0 0 0 5 7 0 0 0 0 - - - - - - - - - - 0 0 0 0 8 6 0 0 0 0 - - - - - - - - - - 
- - - - - - - - - - 0 0 0 0 7 5 0 0 0 0 - - - - - - - - - - 0 0 0 0 6 8 0 0 0 0 - - - - - - - - - - 
- - - - - - - - - - 0 0 0 0 0 0 0 0 0 0 - - - - - - - - - - 0 0 0 0 0 0 0 0 0 0 - - - - - - - - - - 
- - - - - - - - - - 0 0 0 0 0 0 0 0 0 0 - - - - - - - - - - 0 0 0 0 0 0 0 0 0 0 - - - - - - - - - - 
- - - - - - - - - - 0 0 0 0 0 0 0 0 0 0 - - - - - - - - - - 0 0 0 0 0 0 0 0 0 0 - - - - - - - - - - 
- - - - - - - - - - 0 0 0 0 0 0 0 0 0 0 - - - - - - - - - - 0 0 0 0 0 0 0 0 0 0 - - - - - - - - - - 
0 0 0 0 0 0 0 0 0 0 - - - - - - - - - - 0 0 0 0 0 0 0 0 0 0 - - - - - - - - - - 0 0 0 0 0 0 0 0 0 0 
0 0 0 0 0 0 0 0 0 0 - - - - - - - - - - 0 0 0 0 0 0 0 0 0 0 - - - - - - - - - - 0 0 0 0 0 0 0 0 0 0 
0 0 0 0 0 0 0 0 0 0 - - - - - - - - - - 0 0 0 0 0 0 0 0 0 0 - - - - - - - - - - 0 0 0 0 0 0 0 0 0 0 
0 0 0 8 7 6 5 0 0 0 - - - - - - - - - - 0 0 0 b i c b 0 0 0 - - - - - - - - - - 0 0 0 1 2 3 4 0 0 0 
0 0 0 7 6 5 8 0 0 0 - - - - - - - - - - 0 0 0 c x x i 0 0 0 - - - - - - - - - - 0 0 0 4 1 2 3 0 0 0 
0 0 0 6 5 8 7 0 0 0 - - - - - - - - - - 0 0 0 i x x c 0 0 0 - - - - - - - - - - 0 0 0 3 4 1 2 0 0 0 
0 0 0 5 8 7 6 0 0 0 - - - - - - - - - - 0 0 0 b c i b 0 0 0 - - - - - - - - - - 0 0 0 2 3 4 1 0 0 0 
0 0 0 0 0 0 0 0 0 0 - - - - - - - - - - 0 0 0 0 0 0 0 0 0 0 - - - - - - - - - - 0 0 0 0 0 0 0 0 0 0 
0 0 0 0 0 0 0 0 0 0 - - - - - - - - - - 0 0 0 0 0 0 0 0 0 0 - - - - - - - - - - 0 0 0 0 0 0 0 0 0 0 
0 0 0 0 0 0 0 0 0 0 - - - - - - - - - - 0 0 0 0 0 0 0 0 0 0 - - - - - - - - - - 0 0 0 0 0 0 0 0 0 0 
- - - - - - - - - - 0 0 0 0 0 0 0 0 0 0 - - - - - - - - - - 0 0 0 0 0 0 0 0 0 0 - - - - - - - - - - 
- - - - - - - - - - 0 0 0 0 0 0 0 0 0 0 - - - - - - - - - - 0 0 0 0 0 0 0 0 0 0 - - - - - - - - - - 
- - - - - - - - - - 0 0 0 0 0 0 0 0 0 0 - - - - - - - - - - 0 0 0 0 0 0 0 0 0 0 - - - - - - - - - - 
- - - - - - - - - - 0 0 0 0 0 0 0 0 0 0 - - - - - - - - - - 0 0 0 0 0 0 0 0 0 0 - - - - - - - - - - 
- - - - - - - - - - 0 0 0 0 2 4 0 0 0 0 - - - - - - - - - - 0 0 0 0 3 1 0 0 0 0 - - - - - - - - - - 
- - - - - - - - - - 0 0 0 0 4 2 0 0 0 0 - - - - - - - - - - 0 0 0 0 1 3 0 0 0 0 - - - - - - - - - - 
- - - - - - - - - - 0 0 0 0 0 0 0 0 0 0 - - - - - - - - - - 0 0 0 0 0 0 0 0 0 0 - - - - - - - - - - 
- - - - - - - - - - 0 0 0 0 0 0 0 0 0 0 - - - - - - - - - - 0 0 0 0 0 0 0 0 0 0 - - - - - - - - - - 
- - - - - - - - - - 0 0 0 0 0 0 0 0 0 0 - - - - - - - - - - 0 0 0 0 0 0 0 0 0 0 - - - - - - - - - - 
- - - - - - - - - - 0 0 0 0 0 0 0 0 0 0 - - - - - - - - - - 0 0 0 0 0 0 0 0 0 0 - - - - - - - - - - 
0 0 0 0 0 0 0 0 0 0 - - - - - - - - - - 0 0 0 0 0 0 0 0 0 0 - - - - - - - - - - 0 0 0 0 0 0 0 0 0 0 
0 0 0 0 0 0 0 0 0 0 - - - - - - - - - - 0 0 0 0 0 0 0 0 0 0 - - - - - - - - - - 0 0 0 0 0 0 0 0 0 0 
0 0 0 0 0 0 0 0 0 0 - - - - - - - - - - 0 0 0 0 0 0 0 0 0 0 - - - - - - - - - - 0 0 0 0 0 0 0 0 0 0 
0 0 0 0 0 0 0 0 0 0 - - - - - - - - - - 0 0 0 0 0 0 0 0 0 0 - - - - - - - - - - 0 0 0 0 0 0 0 0 0 0 
0 0 0 0 6 5 0 0 0 0 - - - - - - - - - - 0 0 0 0 c i 0 0 0 0 - - - - - - - - - - 0 0 0 0 8 7 0 0 0 0 
0 0 0 0 5 6 0 0 0 0 - - - - - - - - - - 0 0 0 0 b c 0 0 0 0 - - - - - - - - - - 0 0 0 0 7 8 0 0 0 0 
0 0 0 0 0 0 0 0 0 0 - - - - - - - - - - 0 0 0 0 i b 0 0 0 0 - - - - - - - - - - 0 0 0 0 0 0 0 0 0 0 
0 0 0 0 0 0 0 0 0 0 - - - - - - - - - - 0 0 0 0 0 0 0 0 0 0 - - - - - - - - - - 0 0 0 0 0 0 0 0 0 0 
0 0 0 0 0 0 0 0 0 0 - - - - - - - - - - 0 0 0 0 0 0 0 0 0 0 - - - - - - - - - - 0 0 0 0 0 0 0 0 0 0 
0 0 0 0 0 0 0 0 0 0 - - - - - - - - - - 0 0 0 0 0 0 0 0 0 0 - - - - - - - - - - 0 0 0 0 0 0 0 0 0 0 
9 3 2 <-> 20 3 6
9 4 2 <-> 20 4 6
9 5 2 <-> 20 5 6
9 6 2 <-> 20 6 6
29 3 2 <-> 40 3 6
40 4 6 <-> 29 4 2
29 5 2 <-> 40 5 6
29 6 2 <-> 40 6 6
49 3 2 <-> 0 3 6
0 4 6 <-> 49 4 2
49 5 2 <-> 0 5 6
0 6 6 <-> 49 6 2
10 13 6 <-> 39 13 2
39 14 2 <-> 10 14 6
10 15 6 <-> 39 15 2
39 16 2 <-> 10 16 6
19 13 2 <-> 30 13 6
30 14 6 <-> 19 14 2
19 15 2 <-> 30 15 6
30 16 6 <-> 19 16 2
9 23 2 <-> 20 23 6
20 24 6 <-> 9 24 2
9 25 2 <-> 20 25 6
9 26 2 <-> 20 26 6
29 23 2 <-> 40 23 6
40 24 6 <-> 29 24 2
29 25 2 <-> 40 25 6
40 26 6 <-> 29 26 2
30 33 6 <-> 19 33 2
19 34 2 <-> 30 34 6
30 35 6 <-> 19 35 2
19 36 2 <-> 30 36 6
39 33 2 <-> 10 33 6
10 34 6 <-> 39 34 2
39 35 2 <-> 10 35 6
10 36 6 <-> 39 36 2
49 23 2 <-> 0 23 6
0 24 6 <-> 49 24 2
49 25 2 <-> 0 25 6
0 26 6 <-> 49 26 2
9 43 2 <-> 20 43 6
20 44 6 <-> 9 44 2
9 45 2 <-> 20 45 6
20 46 6 <-> 9 46 2
40 43 6 <-> 29 43 2
29 44 2 <-> 40 44 6
40 45 6 <-> 29 45 2
29 46 2 <-> 40 46 6
49 43 2 <-> 0 43 6
0 44 6 <-> 49 44 2
49 45 2 <-> 0 45 6
0 46 6 <-> 49 46 2
4 9 4 <-> 4 20 0
5 20 0 <-> 5 9 4
24 9 4 <-> 24 20 0
25 20 0 <-> 25 9 4
44 9 4 <-> 44 20 0
45 20 0 <-> 45 9 4
34 19 4 <-> 34 30 0
35 19 4 <-> 35 30 0
34 10 0 <-> 34 39 4
35 39 4 <-> 35 10 1
15 10 0 <-> 15 39 4
14 39 4 <-> 14 10 0
14 19 4 <-> 14 30 0
15 30 0 <-> 15 19 4
4 29 4 <-> 4 40 0
5 40 0 <-> 5 29 4
24 29 4 <-> 24 40 0
25 40 0 <-> 25 29 4
44 29 4 <-> 44 40 0
45 40 0 <-> 45 29 4
44 49 4 <-> 44 0 0
45 0 0 <-> 45 49 4
24 49 4 <-> 24 0 0
25 0 0 <-> 25 49 4
4 49 4 <-> 4 0 0
5 0 0 <-> 5 49 4
