8
6
2 1
50 40
1 2 c 0 0 0 0 0 - - - 0 0 0 0 0 i b x c c x b i 0 0 0 0 0 - - - 0 0 0 0 0 c 3 4
2 1 c 0 0 0 0 0 - - - 0 0 0 0 0 i b x c c x b i 0 0 0 0 0 - - - 0 0 0 0 0 c 4 3
c c c 0 0 0 0 0 0 0 0 0 0 0 0 0 i b x c c x b i 0 0 0 0 0 0 0 0 0 0 0 0 0 c c c
i i i i i i i i i i i i i i i i i i i i i i i i i i i i i i i i i i i i i i i i
b i c 0 0 0 0 0 0 0 0 0 0 0 0 i c b x c c x b i c 0 0 0 0 0 0 0 0 0 0 0 0 i c b
b i 0 i 0 0 0 0 0 0 0 0 0 0 c 0 c b x c c x b i 0 i 0 0 0 0 0 0 0 0 0 0 c 0 c b
b i 0 0 c 0 0 0 0 0 0 0 0 i 0 0 c b x c c x b i 0 0 c 0 0 0 0 0 0 0 0 i 0 0 c b
b i 0 0 0 i 0 0 0 0 0 0 c 0 0 0 c b x c c x b i 0 0 0 i 0 0 0 0 0 0 c 0 0 0 c b
b i 0 0 0 0 c 0 0 0 0 i 0 0 0 0 c b x c c x b i 0 0 0 0 c 0 0 0 0 i 0 0 0 0 c b
b i 0 0 0 0 0 i c i c 0 0 0 0 0 c b x c c x b i 0 0 0 0 0 i c i c 0 0 0 0 0 c b
b i - - - - - - 3 7 - - - - - - c b x c c x b i - - - - - - 2 6 - - - - - - c b
b i - - - - - - 7 3 - - - - - - c b x c c x b i - - - - - - 6 2 - - - - - - c b
b i 0 0 0 0 0 i c i c 0 0 0 0 0 c b x c c x b i 0 0 0 0 0 i c i c 0 0 0 0 0 c b
b i 0 0 0 0 c 0 0 0 0 i 0 0 0 0 c b x c c x b i 0 0 0 0 c 0 0 0 0 i 0 0 0 0 c b
b i 0 0 0 i 0 0 0 0 0 0 c 0 0 0 c b x c c x b i 0 0 0 i 0 0 0 0 0 0 c 0 0 0 c b
b i 0 0 c 0 0 0 0 0 0 0 0 i 0 0 c b x c c x b i 0 0 c 0 0 0 0 0 0 0 0 i 0 0 c b
b i 0 i 0 0 0 0 0 0 0 0 0 0 c 0 c b x c c x b i 0 i 0 0 0 0 0 0 0 0 0 0 c 0 c b
b i c 0 0 0 0 0 0 0 0 0 0 0 0 i c b x c c x b i c 0 0 0 0 0 0 0 0 0 0 0 0 i c b
b i i i i i i i i i i i i i i i i b x c c x b i i i i i i i i i i i i i i i i b
b c b c 0 0 0 0 c i 0 0 0 0 c b i b x c c x b c b c 0 0 0 0 i c 0 0 0 0 c b i b
b c 0 0 c 0 0 0 c i 0 0 0 c 0 0 i b x c c x b c 0 0 c 0 0 0 i c 0 0 0 c 0 0 i b
b c 0 0 0 c 0 0 c i 0 0 c 0 0 0 i b x c c x b c 0 0 0 c 0 0 i c 0 0 c 0 0 0 i b
b c 0 0 0 0 i i i i i i 0 0 0 0 i b x c c x b c 0 0 0 0 i i i i i i 0 0 0 0 i b
b c 0 0 0 0 i 1 3 6 8 i 0 0 0 0 i b x c c x b c 0 0 0 0 i 7 4 5 2 i 0 0 0 0 i b
b c i i i i i 8 1 3 6 i c c c c i b x c c x b c i i i i i 5 2 4 7 i c c c c i b
b c c c c c i 3 6 8 1 i i i i i i b x c c x b c c c c c i 2 5 7 4 i i i i i i b
b c 0 0 0 0 i 6 8 1 3 i 0 0 0 0 i b x c c x b c 0 0 0 0 i 4 7 2 5 i 0 0 0 0 i b
b c 0 0 0 0 i i i i i i 0 0 0 0 i b x c c x b c 0 0 0 0 i i i i i i 0 0 0 0 i b
b c 0 0 0 c 0 0 i c 0 0 c 0 0 0 i b x c c x b c 0 0 0 c 0 0 c i 0 0 c 0 0 0 i b
b c 0 0 c 0 0 0 i c 0 0 0 c 0 0 i b x c c x b c 0 0 c 0 0 0 c i 0 0 0 c 0 0 i b
b c b c 0 0 0 0 i c 0 0 0 0 c b i b x c c x b c b c 0 0 0 0 c i 0 0 0 0 c b i b
b i i i i i i i i i i i i i i i i b x c c x b i i i i i i i i i i i i i i i i b
b i c 0 0 0 0 0 0 0 0 0 0 0 0 i c b x c c x b i c 0 0 0 0 0 0 0 0 0 0 0 0 i c b
b i 0 i 0 0 0 0 0 0 0 0 0 0 c 0 c b x c c x b i 0 i 0 0 0 0 0 0 0 0 0 0 c 0 c b
b i 0 0 c 0 0 0 0 0 0 0 0 i 0 0 c b x c c x b i 0 0 c 0 0 0 0 0 0 0 0 i 0 0 c b
b i 0 0 0 i 0 0 0 0 0 0 c 0 0 0 c b x c c x b i 0 0 0 i 0 0 0 0 0 0 c 0 0 0 c b
b i 0 0 0 0 c 0 0 0 0 i 0 0 0 0 c b x c c x b i 0 0 0 0 c 0 0 0 0 i 0 0 0 0 c b
b i 0 0 0 0 0 i c i c 0 0 0 0 0 c b x c c x b i 0 0 0 0 0 i c i c 0 0 0 0 0 c b
b i - - - - - - 1 5 - - - - - - c b x c c x b i - - - - - - 4 8 - - - - - - c b
b i - - - - - - 5 1 - - - - - - c b x c c x b i - - - - - - 8 4 - - - - - - c b
b i 0 0 0 0 0 i c i c 0 0 0 0 0 c b x c c x b i 0 0 0 0 0 i c i c 0 0 0 0 0 c b
b i 0 0 0 0 c 0 0 0 0 i 0 0 0 0 c b x c c x b i 0 0 0 0 c 0 0 0 0 i 0 0 0 0 c b
b i 0 0 0 i 0 0 0 0 0 0 c 0 0 0 c b x c c x b i 0 0 0 i 0 0 0 0 0 0 c 0 0 0 c b
b i 0 0 c 0 0 0 0 0 0 0 0 i 0 0 c b x c c x b i 0 0 c 0 0 0 0 0 0 0 0 i 0 0 c b
b i 0 i 0 0 0 0 0 0 0 0 0 0 c 0 c b x c c x b i 0 i 0 0 0 0 0 0 0 0 0 0 c 0 c b
b i c 0 0 0 0 0 0 0 0 0 0 0 0 i c b x c c x b i c 0 0 0 0 0 0 0 0 0 0 0 0 i c b
i i i i i i i i i i i i i i i i i i i i i i i i i i i i i i i i i i i i i i i i
c c c 0 0 0 0 0 0 0 0 0 0 0 0 0 i b x c c x b i 0 0 0 0 0 0 0 0 0 0 0 0 0 c c c
7 8 c 0 0 0 0 0 - - - 0 0 0 0 0 i b x c c x b i 0 0 0 0 0 - - - 0 0 0 0 0 c 5 6
8 7 c 0 0 0 0 0 - - - 0 0 0 0 0 i b x c c x b i 0 0 0 0 0 - - - 0 0 0 0 0 c 6 5
7 0 2 <-> 30 47 4
9 2 0 <-> 32 49 7
11 2 7 <-> 28 48 2
32 0 6 <-> 9 47 4
30 2 0 <-> 11 49 5
28 2 1 <-> 7 48 2
11 47 5 <-> 28 1 2
28 47 3 <-> 7 1 2