8
1
3 1
19 43
- - - - - - - - - - - - - - - - - - - - - - - - - - - - - - - - - - - - - - - - - - - 
- - - - - - - - - - 0 0 0 - - - - - - - i - - i - - - - - - - 0 0 0 - - - - - - - - - 
- - - - - - - - 0 0 0 0 - - - - - - - - 0 0 0 0 - - - - - - - - 0 0 0 0 - - - - - - - 
- - - - - - 0 0 0 0 0 0 - - - - - - - - 0 0 0 0 - - - - - - - - 0 0 0 0 0 0 - - - - - 
- - - - 0 0 0 0 c 0 0 0 - - - - - - - 0 0 0 0 0 0 - - - - - - - 0 0 0 0 0 0 0 0 - - - 
- - - 0 0 0 0 0 0 0 0 0 - - - - - - - 0 0 0 0 0 0 - - - - - - - 0 0 0 c 0 0 0 0 0 - - 
- - 0 0 0 0 0 0 0 0 0 0 0 - - - - - 0 0 0 0 0 0 0 0 - - - - - 0 0 0 0 0 0 0 0 0 0 0 - 
- - 0 0 0 0 0 0 0 0 0 0 0 0 0 - - 0 0 0 0 x x 0 0 0 0 - - 0 0 0 0 0 0 0 0 0 0 0 0 0 0 
- 0 0 1 2 3 4 0 0 0 0 0 0 0 0 0 0 0 0 0 x x x x 0 0 0 0 0 0 0 0 0 0 0 0 0 5 6 7 8 0 0 
- 0 0 2 3 4 1 0 0 0 0 0 0 0 0 0 0 0 0 0 0 x x 0 0 0 0 0 0 0 0 0 0 0 0 0 0 6 7 8 5 0 0 
- 0 0 3 4 1 2 0 0 0 0 0 0 0 0 0 0 0 0 0 0 0 0 0 0 0 0 0 0 0 0 0 0 0 0 0 0 7 8 5 6 0 0 
- 0 0 4 1 2 3 0 0 0 0 0 0 0 0 0 0 0 0 0 0 0 0 0 0 0 0 0 0 b 0 0 0 0 0 0 0 8 5 6 7 0 0 
- 0 0 0 0 0 0 0 0 0 0 0 0 0 0 0 0 0 0 0 0 0 0 0 0 0 0 0 0 0 0 0 0 0 0 0 0 0 0 0 0 0 0 
- - 0 0 0 0 0 0 0 0 0 0 0 0 c 0 0 0 0 0 0 0 0 0 0 0 0 0 0 0 0 0 0 0 0 0 0 0 0 0 0 0 - 
- - 0 0 0 b 0 0 - - - - 0 0 0 0 - - - 0 0 0 0 0 0 - - - 0 0 0 0 - - - - 0 0 0 0 0 0 - 
- - - 0 0 0 0 0 - - - - - 0 0 - - - - - 0 0 i 0 - - - - - 0 0 - - - - - 0 0 0 0 0 - - 
- - - - 0 0 0 0 - - - - - - - - - - - - 0 0 0 0 - - - - - - - - - - - - 0 0 0 0 - - - 
- - - - - - 0 0 - - - - - - - - - - - - - 0 0 - - - - - - - - - - - - - 0 0 - - - - - 
- - - - - - - 0 - - - - - - - - - - - - - 0 0 - - - - - - - - - - - - - 0 - - - - - - 
12 1 2 <-> 20 1 6
12 1 3 <-> 20 2 7
23 2 1 <-> 31 1 5
7 18 4 <-> 36 18 4
23 1 2 <-> 31 1 6
20 1 2 <-> 21 18 6
23 1 6 <-> 22 18 2
