8
1
0 2
21 21
0 0 0 0 0 0 0 0 - - - - - 0 0 0 0 0 0 0 0 
0 b 0 0 0 0 0 0 - - - - - 0 0 0 0 0 0 b 0 
0 0 0 - 0 0 0 0 - - - - - 0 0 0 0 - 0 0 0 
0 0 - - 0 0 0 0 - - - - - 0 0 0 0 - - 0 0 
0 0 0 0 2 1 0 0 - - - - - 0 0 3 4 0 0 0 0 
0 0 0 0 1 2 0 0 - - - - - 0 0 4 3 0 0 0 0 
0 0 0 0 0 0 0 0 - - - - - 0 0 0 0 0 0 0 0 
0 0 0 0 0 0 0 0 - 0 0 0 - 0 0 0 0 0 0 0 0 
- - - - - - - - - 0 0 0 - - - - - - - - - 
- - - - - - - 0 0 0 x 0 0 0 - - - - - - - 
- - - - - - - 0 0 x x x 0 0 - - - - - - - 
- - - - - - - 0 0 0 x 0 0 0 - - - - - - - 
- - - - - - - - - 0 0 0 - - - - - - - - - 
0 0 0 0 0 0 0 0 - 0 0 0 - 0 0 0 0 0 0 0 0 
0 0 0 0 0 0 0 0 - - - - - 0 0 0 0 0 0 0 0 
0 0 0 0 5 6 0 0 - - - - - 0 0 7 8 0 0 0 0 
0 0 0 0 6 5 0 0 - - - - - 0 0 8 7 0 0 0 0 
0 0 - - 0 0 0 0 - - - - - 0 0 0 0 - - 0 0 
0 0 0 - 0 0 0 0 - - - - - 0 0 0 0 - 0 0 0 
0 b 0 0 0 0 0 0 - - - - - 0 0 0 0 0 0 b 0 
0 0 0 0 0 0 0 0 - - - - - 0 0 0 0 0 0 0 0 
0 0 7 <-> 9 7 7
20 0 1 <-> 13 9 1
20 20 3 <-> 11 13 3
0 20 5 <-> 7 11 5
