8
2
0 2
26 32
0 0 0 0 0 0 0 0 0 0 0 0 0 0 0 0 0 0 0 0 x 0 0 0 0 0 x 0 0 0 0 0 
0 0 0 0 0 x 0 0 0 x 0 0 0 x 0 0 0 0 0 0 0 0 0 0 0 0 0 0 0 0 0 0 
0 0 6 7 0 0 0 0 0 0 0 0 0 0 0 0 0 x 0 0 0 0 0 x 0 0 x 2 1 0 0 0 
0 0 7 6 0 0 0 0 0 0 0 0 0 0 0 0 0 0 0 0 0 0 0 0 0 0 0 1 2 0 0 0 
0 0 0 0 0 0 0 - - - - - - - - - - - - - - - - - 0 0 0 0 0 0 x 0 
0 0 x 0 0 0 0 - - - - - - - - - - - - - - - - - 0 0 0 0 0 0 0 0 
0 0 0 0 0 0 0 - - - - - - - - - - - - - - - - - 0 0 0 0 0 x 0 0 
x 0 0 0 - - - - - - - - - - - - - - - - - - - - - - - 0 0 0 0 0 
0 0 0 0 - - - - - b 0 i c 0 b 0 b i 0 i b c - - - - - 0 0 0 0 x 
0 0 0 0 - - - - - c b 0 0 b i 0 c b 0 c 0 0 - - - - - 0 0 0 0 0 
0 0 x 0 - - - - - 0 0 c 0 c 0 b 0 b c 0 i b - - - - - 0 0 0 0 0 
0 0 0 0 - - - - - b c 0 b 0 b 0 i 0 0 c 0 0 - - - - - x 0 0 0 0 
0 0 0 0 - - - - - 0 i 0 0 b i 0 b 0 b i b b - - - - - 0 0 x 0 0 
0 x 0 0 - - - - - 0 c 0 i 0 c i 0 0 0 i c 0 - - - - - 0 0 0 0 0 
x 0 0 0 - - - - - i b b 0 0 b 0 c i c 0 0 i - - - - - 0 0 0 x 0 
0 0 0 0 - - - - - 0 0 i c b c 0 b 0 0 i 0 c - - - - - 0 0 0 0 0 
0 0 0 0 - - - - - c c 0 0 c 0 i 0 b 0 0 b 0 - - - - - 0 0 0 0 0 
0 0 0 0 - - - - - b 0 i b 0 b 0 b i c c 0 b - - - - - 0 x 0 0 x 
0 0 0 0 - - - - - - - - - - - - - - - - - - - - - - - 0 0 0 0 0 
x 0 0 x 0 0 0 - - - - - - - - - - - - - - - - - 0 0 0 0 0 0 0 0 
0 0 0 0 0 0 0 - - - - - - - - - - - - - - - - - 0 0 0 0 0 0 x 0 
0 0 0 0 0 0 0 - - - - - - - - - - - - - - - - - 0 0 0 0 x 0 0 0 
0 0 0 5 8 0 0 0 0 0 0 0 0 0 0 0 0 0 0 0 0 0 0 0 0 0 0 3 4 0 0 0 
0 0 0 8 5 0 0 0 0 0 0 0 0 x 0 0 0 0 0 x 0 0 0 0 0 x 0 4 3 0 0 0 
0 0 0 0 0 x 0 0 x 0 0 0 0 0 0 0 0 0 0 0 0 0 0 0 0 0 0 0 0 0 0 0 
0 0 0 0 0 0 0 0 0 0 0 0 0 0 0 0 0 0 0 x 0 0 0 0 0 0 0 0 0 0 0 0 
21 17 2 <-> 27 17 6
21 16 2 <-> 27 16 6
21 15 2 <-> 27 15 6
21 14 2 <-> 27 14 6
21 13 2 <-> 27 13 6
21 12 2 <-> 27 12 6
21 11 2 <-> 27 11 6
21 10 2 <-> 27 10 6
21 9 2 <-> 27 9 6
21 8 2 <-> 27 8 6
21 17 4 <-> 21 22 0
20 17 4 <-> 20 22 0
19 17 4 <-> 19 22 0
18 22 0 <-> 18 17 4
17 17 4 <-> 17 22 0
15 22 0 <-> 15 17 4
14 17 4 <-> 14 22 0
13 22 0 <-> 13 17 4
12 17 4 <-> 12 22 0
11 22 0 <-> 11 17 4
10 17 4 <-> 10 22 0
9 17 4 <-> 9 22 0
3 17 2 <-> 9 17 6
9 16 6 <-> 3 16 2
9 15 6 <-> 3 15 2
9 14 6 <-> 3 14 2
9 13 6 <-> 3 13 2
9 12 6 <-> 3 12 2
9 11 6 <-> 3 11 2
9 10 6 <-> 3 10 2
9 9 6 <-> 3 9 2
9 8 6 <-> 3 8 2
9 3 4 <-> 9 8 0
10 3 4 <-> 10 8 0
11 3 4 <-> 11 8 0
12 3 4 <-> 12 8 0
13 3 4 <-> 13 8 0
14 3 4 <-> 14 8 0
15 3 4 <-> 15 8 0
16 3 4 <-> 16 8 0
17 3 4 <-> 17 8 0
18 3 4 <-> 18 8 0
16 17 4 <-> 16 22 0
19 8 0 <-> 19 3 4
20 3 4 <-> 20 8 0
21 3 4 <-> 21 8 0
