8
4
2 1
27 44
- - - - - - - - - - - - - - - - - - - - - - - - - - - - - - - - - - - - - - - - - - - - 
- - - - - - - - - - - - - - - - - - 0 0 0 0 0 0 x x x x 0 0 0 0 0 0 - - - - - - - - - - 
- - - - - - - - - - - - - - - - - - 0 0 0 0 0 0 0 0 0 0 0 0 0 0 0 0 - - - - - - - - - - 
- - - - - - - - - - - - - - - - - - 0 0 0 0 0 0 0 0 0 0 0 0 0 0 0 0 - - - - - - - - - - 
- - - - - - - - - - - - - - - - - - 0 0 8 7 0 0 0 0 0 0 0 0 6 2 0 0 - - - - - - - - - - 
- - - - - - - - - - - - - - - - - - 0 0 7 8 0 0 0 0 0 0 0 0 2 6 0 0 - - - - - - - - - - 
- - - - - - - - 0 0 0 0 0 0 0 0 - - 0 0 0 0 0 0 0 0 0 0 0 0 0 0 0 0 - - 0 0 0 0 0 0 0 0 
- - - - - - - - 0 0 0 0 0 0 0 0 - - 0 0 0 0 0 0 0 0 0 0 0 0 0 0 0 0 - - 0 0 0 0 0 0 0 0 
- - - - - - - - 0 0 0 0 0 0 0 0 - - 0 0 0 0 0 0 x x x x 0 0 0 0 0 0 - - 0 0 0 5 8 0 0 0 
- - - - - - - - 0 0 0 7 6 0 0 0 - - - - - - - - - - - - - - - - - - - - 0 0 0 8 5 0 0 0 
- - - - - - - - 0 0 0 6 7 0 0 0 - - - - - - - - - - - - - - - - - - - - 0 0 0 0 0 0 0 0 
- - - - - - - - 0 0 0 0 0 0 0 0 - - - - - 0 0 0 0 b c 0 0 0 0 - - - - - 0 0 0 0 0 0 0 0 
- - - - - - - - x 0 0 0 0 0 0 x - - - - - 0 0 0 0 0 0 0 0 0 0 - - - - - x 0 0 0 0 0 0 x 
- - - - - - - - x 0 0 0 0 0 0 x - - - - - b 0 0 0 0 i 0 0 0 c - - - - - x 0 0 0 0 0 0 x 
- - - - - - - - x 0 0 0 0 0 0 x - - - - - c 0 0 0 i 0 0 0 0 b - - - - - x 0 0 0 0 0 0 x 
- - - - - - - - x 0 0 0 0 0 0 x - - - - - 0 0 0 0 0 0 0 0 0 0 - - - - - x 0 0 0 0 0 0 x 
- - - - - - - - 0 0 0 0 0 0 0 0 - - - - - 0 0 0 0 c b 0 0 0 0 - - - - - 0 0 0 0 0 0 0 0 
- - - - - - - - 0 0 0 0 0 0 0 0 - - - - - - - - - - - - - - - - - - - - 0 0 0 0 0 0 0 0 
- - - - - - - - 0 0 0 2 3 0 0 0 - - - - - - - - - - - - - - - - - - - - 0 0 0 1 4 0 0 0 
- - - - - - - - 0 0 0 3 2 0 0 0 - - 0 0 0 0 0 0 x x x x 0 0 0 0 0 0 - - 0 0 0 4 1 0 0 0 
- - - - - - - - 0 0 0 0 0 0 0 0 - - 0 0 0 0 0 0 0 0 0 0 0 0 0 0 0 0 - - 0 0 0 0 0 0 0 0 
- - - - - - - - 0 0 0 0 0 0 0 0 - - 0 0 0 0 0 0 0 0 0 0 0 0 0 0 0 0 - - 0 0 0 0 0 0 0 0 
- - - - - - - - - - - - - - - - - - 0 0 0 3 1 0 0 0 0 0 0 0 4 5 0 0 - - - - - - - - - - 
- - - - - - - - - - - - - - - - - - 0 0 0 1 3 0 0 0 0 0 0 0 5 4 0 0 - - - - - - - - - - 
- - - - - - - - - - - - - - - - - - 0 0 0 0 0 0 0 0 0 0 0 0 0 0 0 0 - - - - - - - - - - 
- - - - - - - - - - - - - - - - - - 0 0 0 0 0 0 0 0 0 0 0 0 0 0 0 0 - - - - - - - - - - 
- - - - - - - - - - - - - - - - - - 0 0 0 0 0 0 x x x x 0 0 0 0 0 0 - - - - - - - - - - 
43 11 2 <-> 8 11 6
43 12 2 <-> 8 12 6
43 13 2 <-> 8 13 6
43 14 2 <-> 8 14 6
43 15 2 <-> 8 15 6
43 16 2 <-> 8 16 6
23 1 0 <-> 23 26 4
24 1 0 <-> 24 26 4
25 1 0 <-> 25 26 4
26 1 0 <-> 26 26 4
27 1 0 <-> 27 26 4
28 1 0 <-> 28 26 4
24 19 0 <-> 24 16 4
25 19 0 <-> 25 16 4
26 19 0 <-> 26 16 4
27 19 0 <-> 27 16 4
27 11 0 <-> 27 8 4
26 11 0 <-> 26 8 4
25 11 0 <-> 25 8 4
24 11 0 <-> 24 8 4
15 12 2 <-> 21 12 6
15 13 2 <-> 21 13 6
15 14 2 <-> 21 14 6
15 15 2 <-> 21 15 6
30 15 2 <-> 36 15 6
30 14 2 <-> 36 14 6
30 13 2 <-> 36 13 6
30 12 2 <-> 36 12 6
15 19 2 <-> 18 19 6
15 20 2 <-> 18 20 6
15 21 2 <-> 18 21 6
15 6 2 <-> 18 6 6
15 7 2 <-> 18 7 6
15 8 2 <-> 18 8 6
33 8 2 <-> 36 8 6
33 7 2 <-> 36 7 6
33 6 2 <-> 36 6 6
33 19 2 <-> 36 19 6
33 20 2 <-> 36 20 6
33 21 2 <-> 36 21 6
