8
4
1 2
30 30
0 0 0 0 0 - - - - - - - - - - - - - - - - - - - - 0 0 0 0 0 
0 0 0 0 0 0 - - - - - - - - - - - - - - - - - - 0 0 0 0 0 0 
0 0 1 2 0 0 0 - - - - - - - - - - - - - - - - 0 0 0 4 3 0 0 
0 0 2 1 0 0 0 0 - - - - - - - - - - - - - - 0 0 0 0 3 4 0 0 
0 0 0 0 0 0 0 0 0 - - - - - - - - - - - - 0 0 0 0 0 0 0 0 0 
- 0 0 0 0 0 0 0 0 c - - - - - - - - - - c 0 0 0 0 0 0 0 0 - 
- - 0 0 0 0 0 0 0 0 0 - - - - - - - - 0 0 0 0 0 0 0 0 0 - - 
- - - 0 0 0 0 0 0 0 0 0 - - - - - - 0 0 0 0 0 0 0 0 0 - - - 
- - - - 0 0 0 0 0 0 0 0 0 - - - - 0 0 0 0 0 0 0 0 0 - - - - 
- - - - - c 0 0 0 0 0 0 0 0 - - 0 0 0 0 0 0 0 0 c - - - - - 
- - - - - - 0 0 0 0 0 0 0 0 b b 0 0 0 0 0 0 0 0 - - - - - - 
- - - - - - - 0 0 0 0 0 0 0 0 0 0 0 0 0 0 0 0 - - - - - - - 
- - - - - - - - 0 0 0 0 0 0 - - 0 0 0 0 0 0 - - - - - - - - 
- - - - - - - - - 0 0 0 0 - - - - 0 0 0 0 - - - - - - - - - 
- - - - - - - - - - b 0 - - - - - - 0 b - - - - - - - - - - 
- - - - - - - - - - b 0 - - - - - - 0 b - - - - - - - - - - 
- - - - - - - - - 0 0 0 0 - - - - 0 0 0 0 - - - - - - - - - 
- - - - - - - - 0 0 0 0 0 0 - - 0 0 0 0 0 0 - - - - - - - - 
- - - - - - - 0 0 0 0 0 0 0 0 0 0 0 0 0 0 0 0 - - - - - - - 
- - - - - - 0 0 0 0 0 0 0 0 b b 0 0 0 0 0 0 0 0 - - - - - - 
- - - - - c 0 0 0 0 0 0 0 0 - - 0 0 0 0 0 0 0 0 c - - - - - 
- - - - 0 0 0 0 0 0 0 0 0 - - - - 0 0 0 0 0 0 0 0 0 - - - - 
- - - 0 0 0 0 0 0 0 0 0 - - - - - - 0 0 0 0 0 0 0 0 0 - - - 
- - 0 0 0 0 0 0 0 0 0 - - - - - - - - 0 0 0 0 0 0 0 0 0 - - 
- 0 0 0 0 0 0 0 0 c - - - - - - - - - - c 0 0 0 0 0 0 0 0 - 
0 0 0 0 0 0 0 0 0 - - - - - - - - - - - - 0 0 0 0 0 0 0 0 0 
0 0 8 7 0 0 0 0 - - - - - - - - - - - - - - 0 0 0 0 5 6 0 0 
0 0 7 8 0 0 0 - - - - - - - - - - - - - - - - 0 0 0 6 5 0 0 
0 0 0 0 0 0 - - - - - - - - - - - - - - - - - - 0 0 0 0 0 0 
0 0 0 0 0 - - - - - - - - - - - - - - - - - - - - 0 0 0 0 0 
12 16 1 <-> 12 13 3
13 17 1 <-> 16 17 7
17 16 7 <-> 17 13 5
16 12 5 <-> 13 12 3
11 14 2 <-> 18 14 6
11 15 2 <-> 18 15 6
14 18 0 <-> 14 11 4
15 18 0 <-> 15 11 4
