8
4
4 3
49 49
0 0 0 0 0 0 0 0 0 0 0 0 0 0 0 0 0 0 0 0 0 0 0 0 0 0 0 0 0 0 0 0 0 0 0 0 0 0 0 0 0 0 0 0 0 0 0 0 0 
0 0 0 0 0 0 0 0 0 0 0 0 0 0 0 0 0 0 0 0 0 0 0 0 - 0 0 0 0 0 0 0 0 0 0 0 0 0 0 0 0 0 0 0 0 0 0 0 0 
0 0 0 0 0 0 0 0 0 - 0 0 0 0 0 0 0 0 0 0 0 0 0 - b - 0 0 0 0 0 0 0 0 0 0 0 0 0 - 0 0 0 0 0 0 0 0 0 
0 0 0 0 0 0 0 0 - - - 0 0 0 0 0 0 0 0 0 0 0 0 0 - 0 0 0 0 0 0 0 0 0 0 0 0 0 - - - 0 0 0 0 0 0 0 0 
0 0 0 0 0 0 0 - - 0 - - 0 0 0 0 0 0 0 0 0 0 0 - c - 0 0 0 0 0 0 0 0 0 0 0 - - 0 - - 0 0 0 0 0 0 0 
0 0 0 0 0 0 - - 0 b 0 - - 0 0 0 0 0 0 0 0 0 0 0 - 0 0 0 0 0 0 0 0 0 0 0 - - 0 b 0 - - 0 0 0 0 0 0 
0 0 0 0 0 0 0 - - 0 - - 0 0 0 0 0 0 0 0 0 0 0 - c - 0 0 0 0 0 0 0 0 0 0 0 - - 0 - - 0 0 0 0 0 0 0 
0 0 0 0 0 0 0 0 - - - 0 0 0 0 0 0 0 0 0 0 0 0 0 - 0 0 0 0 0 0 0 0 0 0 0 0 0 - - - 0 0 0 0 0 0 0 0 
0 0 0 0 0 0 0 0 0 - 0 0 0 0 0 0 0 0 0 0 0 0 - - b - - 0 0 0 0 0 0 0 0 0 0 0 0 - 0 0 0 0 0 0 0 0 0 
0 0 0 0 0 0 0 0 0 0 0 0 0 0 0 0 0 0 0 0 0 - 0 0 - 0 0 - 0 0 0 0 0 0 0 0 0 0 0 0 0 0 0 0 0 0 0 0 0 
0 0 0 0 0 0 0 0 0 0 0 0 0 0 b 0 0 0 0 0 - 0 0 0 0 0 0 0 - 0 0 0 0 0 b 0 0 0 0 0 0 0 0 0 0 0 0 0 0 
0 0 0 0 0 0 0 0 0 0 0 0 0 0 0 0 0 0 0 - 0 0 0 0 0 0 0 0 0 - 0 0 0 0 0 0 0 0 0 0 0 0 0 0 0 0 0 0 0 
0 0 0 0 0 0 0 0 0 0 0 0 0 0 0 0 0 0 - 0 0 0 0 0 0 0 0 0 0 0 - 0 0 0 0 0 0 0 0 0 0 0 0 0 0 0 0 0 0 
0 0 0 0 0 0 0 0 0 0 0 0 0 0 0 0 0 - 0 0 0 0 0 0 0 0 0 0 0 0 0 - 0 0 0 0 0 0 0 0 0 0 0 0 0 0 0 0 0 
0 0 0 0 0 0 0 0 0 0 0 0 0 0 0 0 - 0 0 0 0 0 0 0 c 0 0 0 0 0 0 0 - 0 0 0 0 0 0 0 0 0 0 0 0 0 0 0 0 
0 0 0 0 0 0 0 0 0 0 0 0 0 0 0 - 0 0 0 0 0 0 0 - 0 - 0 0 0 0 0 0 0 - 0 0 0 0 0 0 0 0 0 0 0 0 0 0 0 
0 0 0 0 0 0 0 0 0 0 0 0 0 0 - 0 0 0 0 0 0 0 0 - 0 - 0 0 0 0 0 0 0 0 - 0 0 0 0 0 0 0 0 0 0 0 0 0 0 
- 0 0 0 0 0 0 0 0 0 0 0 0 - 0 0 0 0 0 0 0 0 - 0 0 0 - 0 0 0 0 0 0 0 0 - 0 0 0 0 0 0 0 0 0 0 0 0 - 
- - 0 0 0 0 0 0 0 0 - - - 0 0 0 0 0 0 0 0 - 0 0 0 0 0 - 0 0 0 0 0 0 0 0 - - - 0 0 0 0 0 0 0 0 - - 
- - - 0 0 0 0 0 0 0 - - - 0 0 0 0 0 0 0 - 0 0 0 c 0 0 0 - 0 0 0 0 0 0 0 - - - 0 0 0 0 0 0 0 - - - 
0 - - - 0 0 0 0 0 0 - - - 0 0 0 0 0 0 - 0 0 0 0 0 0 0 0 0 - 0 0 0 0 0 0 - - - 0 0 0 0 0 0 - - - 0 
x 0 - - - 0 0 0 0 0 0 0 0 0 0 0 0 0 - 0 0 0 0 - - - 0 0 0 0 - 0 0 0 0 0 0 0 0 0 0 0 0 0 - - - 0 x 
0 x 0 - - - 0 0 0 0 0 0 0 0 0 0 0 - 0 0 0 0 0 0 b 0 0 0 0 0 0 - 0 0 0 0 0 0 0 0 0 0 0 - - - 0 x 0 
b 0 x 0 - - - 0 0 0 0 0 0 0 0 0 - 0 0 0 0 0 - - - - - 0 0 0 0 0 - 0 0 0 0 0 0 0 0 0 - - - 0 x 0 b 
0 x 0 - - - 0 0 0 0 0 0 0 0 0 0 0 0 0 0 0 0 0 0 b 0 0 0 0 0 0 0 0 0 0 0 0 0 0 0 0 0 0 - - - 0 x 0 
x 0 - - - 0 0 0 0 0 0 0 0 0 0 0 0 0 0 0 0 - - - - - - - 0 0 0 0 0 0 0 0 0 0 0 0 0 0 0 0 - - - 0 x 
0 - - - 0 0 0 0 0 0 0 0 0 0 0 0 0 0 0 0 0 0 0 0 b 0 0 0 0 0 0 0 0 0 0 0 0 0 0 0 0 0 0 0 0 - - - 0 
- - - 0 0 0 0 0 0 0 0 0 0 0 0 0 0 0 0 - - - - - - - - - - - 0 0 0 0 0 0 0 0 0 0 0 0 0 0 0 0 - - - 
- - 0 0 0 0 0 0 0 0 0 0 0 0 0 0 0 0 0 0 0 0 0 0 b 0 0 0 0 0 0 0 0 0 0 0 0 0 0 0 0 0 0 0 0 0 0 - - 
- 0 0 0 0 0 0 0 0 0 - - - - 0 0 - - - - - - - - - - - - - - - - - 0 0 - - - - 0 0 0 0 0 0 0 0 0 - 
0 0 0 0 0 0 0 0 0 - - - - - 0 0 0 0 0 0 0 0 0 0 b 0 0 0 0 0 0 0 0 0 0 - - - - - 0 0 0 0 0 0 0 0 0 
0 0 0 0 0 0 0 0 0 - - i x 0 0 0 0 0 0 0 0 0 0 0 0 0 0 0 0 0 0 0 0 0 0 0 x i - - 0 0 0 0 0 0 0 0 0 
0 0 0 0 0 0 0 0 0 - - x x 0 - 0 - 0 - 0 0 0 0 0 - 0 0 0 0 0 - 0 - 0 - 0 x x - - 0 0 0 0 0 0 0 0 0 
0 0 0 0 0 0 0 0 - - - 0 0 0 0 - 0 - 0 - 0 0 0 0 - 0 0 0 0 - 0 - 0 - 0 0 0 0 - - - 0 0 0 0 0 0 0 0 
0 0 0 0 0 0 0 - - - 0 0 0 0 - 0 - 0 - 0 0 0 0 0 - 0 0 0 0 0 - 0 - 0 - 0 0 0 0 - - - 0 0 0 0 0 0 0 
0 0 0 0 0 0 0 - - 0 0 0 0 0 0 - 0 - 0 - 0 0 0 0 - 0 0 0 0 - 0 - 0 - 0 0 0 0 0 0 - - 0 0 0 0 0 0 0 
0 0 0 0 0 0 0 0 0 0 0 0 0 0 - 0 - 0 - 0 0 0 0 0 - 0 0 0 0 0 - 0 - 0 - 0 0 0 0 0 0 0 0 0 0 0 0 0 0 
0 0 0 0 0 0 0 0 0 0 0 0 0 0 0 - 0 - 0 - 0 0 0 0 - 0 0 0 0 - 0 - 0 - 0 0 0 0 0 0 0 0 0 0 0 0 0 0 0 
0 0 0 0 0 0 0 0 0 0 0 0 0 0 0 0 0 0 0 0 0 0 0 0 0 0 0 0 0 0 0 0 0 0 0 0 0 0 0 0 0 0 0 0 0 0 0 0 0 
0 0 0 0 0 0 8 7 6 5 0 0 0 0 0 0 0 0 0 0 0 0 0 0 0 0 0 0 0 0 0 0 0 0 0 0 0 0 0 4 2 1 3 0 0 0 0 0 0 
- 0 0 0 0 0 5 6 7 8 0 0 0 0 0 0 - - 0 0 0 0 0 0 0 0 0 0 0 0 0 - - 0 0 0 0 0 0 3 1 2 4 0 0 0 0 0 - 
- 0 0 0 0 0 6 5 8 7 0 0 0 0 0 0 - - 0 0 0 0 0 0 0 0 0 0 0 0 0 - - 0 0 0 0 0 0 1 3 4 2 0 0 0 0 0 - 
0 0 0 0 0 0 7 8 5 6 0 0 0 0 0 0 - - 0 0 0 b 0 0 0 0 0 b 0 0 0 - - 0 0 0 0 0 0 2 4 3 1 0 0 0 0 0 0 
0 0 0 0 0 0 0 0 0 0 0 0 0 0 - 0 - - 0 0 0 0 0 0 0 0 0 0 0 0 0 - - 0 - 0 0 0 0 0 0 0 0 0 0 0 0 0 0 
0 0 0 0 0 0 0 0 0 0 0 0 0 0 0 b - - 0 0 0 0 0 0 0 0 0 0 0 0 0 - - b 0 0 0 0 0 0 0 0 0 0 0 0 0 0 0 
0 0 0 0 0 0 0 0 0 0 0 0 0 - - - - - 0 0 0 0 0 0 b 0 0 0 0 0 0 - - - - - 0 0 0 0 0 0 0 0 0 0 0 0 0 
0 0 0 0 0 0 0 0 0 0 0 0 0 - - - - 0 0 0 0 0 0 0 0 0 0 0 0 0 0 0 - - - - 0 0 0 0 0 0 0 0 0 0 0 0 0 
0 0 0 0 0 0 0 0 0 0 0 0 0 0 0 0 0 0 0 0 0 0 0 0 0 0 0 0 0 0 0 0 0 0 0 0 0 0 0 0 0 0 0 0 0 0 0 0 0 
0 0 0 0 0 0 0 0 0 0 0 - - 0 0 0 0 0 0 - - - 0 0 c 0 0 - - - 0 0 0 0 0 0 - - 0 0 0 0 0 0 0 0 0 0 0 
24 38 0 <-> 24 31 4
39 9 0 <-> 39 6 4
35 5 2 <-> 38 5 6
39 1 4 <-> 39 4 0
40 5 2 <-> 43 5 6
9 1 4 <-> 9 4 0
10 5 2 <-> 13 5 6
9 6 4 <-> 9 9 0
5 5 2 <-> 8 5 6
41 23 2 <-> 45 23 6
47 24 5 <-> 44 27 1
48 26 4 <-> 48 30 0
47 22 7 <-> 44 19 3
48 16 4 <-> 48 20 0
0 20 0 <-> 0 16 4
1 22 1 <-> 4 19 5
3 23 2 <-> 7 23 6
1 24 3 <-> 4 27 7
0 30 0 <-> 0 26 4
30 48 6 <-> 26 48 2
18 48 2 <-> 22 48 6
39 21 7 <-> 25 7 3
23 7 5 <-> 9 21 1
