8
15
10 2 
50 50
c b 0 0 0 0 0 0 0 0 0 0 0 0 0 0 0 0 0 0 0 0 0 0 0 0 0 0 0 0 0 0 0 0 0 0 0 0 0 0 0 0 0 0 0 0 0 0 b c 
b b 0 0 0 0 0 0 0 0 0 0 0 0 0 0 0 0 0 0 0 0 0 0 0 0 0 0 0 0 0 0 0 0 0 0 0 0 0 0 0 0 0 0 0 0 0 0 b b 
0 0 - - - - - - - - - - 0 0 - - - - - - 0 0 - - 0 0 - - 0 0 - - - - - - 0 0 - - - - - - - - - - 0 0 
0 0 - - - - - - - - - - 0 0 - - - - - - 0 0 - - 0 0 - - 0 0 - - - - - - 0 0 - - - - - - - - - - 0 0 
0 0 - - x x 0 0 0 0 0 0 x x 0 0 0 0 0 0 x x 0 0 0 0 0 0 x x 0 0 0 0 0 0 x x 0 0 0 0 0 0 x x - - 0 0 
0 0 - - x x 0 0 0 0 0 0 x x 0 0 0 0 0 0 x x 0 0 0 0 0 0 x x 0 0 0 0 0 0 x x 0 0 0 0 0 0 x x - - 0 0 
0 0 - - 0 0 - - 0 0 - - 0 0 - - 0 0 - - 0 0 - - 0 0 - - 0 0 - - 0 0 - - 0 0 - - 0 0 - - 0 0 - - 0 0 
0 0 - - 0 0 - - 0 0 - - 0 0 - - 0 0 - - 0 0 - - 0 0 - - 0 0 - - 0 0 - - 0 0 - - 0 0 - - 0 0 - - 0 0 
0 0 - - 0 0 0 0 1 2 0 0 0 0 0 0 0 0 0 0 0 0 0 0 0 0 0 0 0 0 0 0 0 0 0 0 0 0 0 0 4 3 0 0 0 0 - - 0 0 
0 0 - - 0 0 0 0 2 1 0 0 0 0 0 0 0 0 0 0 0 0 0 0 0 0 0 0 0 0 0 0 0 0 0 0 0 0 0 0 3 4 0 0 0 0 - - 0 0 
0 0 - - 0 0 - - 0 0 - - 0 0 - - 0 0 - - 0 0 - - 0 0 - - 0 0 - - 0 0 - - 0 0 - - 0 0 - - 0 0 - - 0 0 
0 0 - - 0 0 - - 0 0 - - 0 0 - - 0 0 - - 0 0 - - 0 0 - - 0 0 - - 0 0 - - 0 0 - - 0 0 - - 0 0 - - 0 0 
0 0 0 0 x x 0 0 0 0 0 0 x x 0 0 0 0 0 0 x x 0 0 0 0 0 0 x x 0 0 0 0 0 0 x x 0 0 0 0 0 0 x x 0 0 0 0 
0 0 0 0 x x 0 0 0 0 0 0 x x 0 0 0 0 0 0 x x 0 0 0 0 0 0 x x 0 0 0 0 0 0 x x 0 0 0 0 0 0 x x 0 0 0 0 
0 0 - - 0 0 - - 0 0 - - 0 0 - - 0 0 - - 0 0 - - 0 0 - - 0 0 - - 0 0 - - 0 0 - - 0 0 - - 0 0 - - 0 0 
0 0 - - 0 0 - - 0 0 - - 0 0 - - 0 0 - - 0 0 - - 0 0 - - 0 0 - - 0 0 - - 0 0 - - 0 0 - - 0 0 - - 0 0 
0 0 - - 0 0 0 0 0 0 0 0 0 0 0 0 0 0 0 0 0 0 0 0 0 0 0 0 0 0 0 0 0 0 0 0 0 0 0 0 0 0 0 0 0 0 - - 0 0 
0 0 - - 0 0 0 0 0 0 0 0 0 0 0 0 0 0 0 0 0 0 0 0 0 0 0 0 0 0 0 0 0 0 0 0 0 0 0 0 0 0 0 0 0 0 - - 0 0 
0 0 - - 0 0 - - 0 0 - - 0 0 - - 0 0 - - 0 0 - - - - - - 0 0 - - 0 0 - - 0 0 - - 0 0 - - 0 0 - - 0 0 
0 0 - - 0 0 - - 0 0 - - 0 0 - - 0 0 - - 0 0 - - - - - - 0 0 - - 0 0 - - 0 0 - - 0 0 - - 0 0 - - 0 0 
0 0 0 0 x x 0 0 0 0 0 0 x x 0 0 0 0 0 0 x x 0 0 0 0 0 0 x x 0 0 0 0 0 0 x x 0 0 0 0 0 0 x x 0 0 0 0 
0 0 0 0 x x 0 0 0 0 0 0 x x 0 0 0 0 0 0 x x 0 0 0 0 0 0 x x 0 0 0 0 0 0 x x 0 0 0 0 0 0 x x 0 0 0 0 
0 0 - - 0 0 - - 0 0 - - 0 0 - - 0 0 - - 0 0 - - 1 2 - - 0 0 - - 0 0 - - 0 0 - - 0 0 - - 0 0 - - 0 0 
0 0 - - 0 0 - - 0 0 - - 0 0 - - 0 0 - - 0 0 - - 3 4 - - 0 0 - - 0 0 - - 0 0 - - 0 0 - - 0 0 - - 0 0 
0 0 0 0 0 0 0 0 0 0 0 0 0 0 0 0 0 0 - - 0 0 5 7 b b 6 8 0 0 - - 0 0 0 0 0 0 0 0 0 0 0 0 0 0 0 0 0 0 
0 0 0 0 0 0 0 0 0 0 0 0 0 0 0 0 0 0 - - 0 0 6 8 b b 5 7 0 0 - - 0 0 0 0 0 0 0 0 0 0 0 0 0 0 0 0 0 0 
0 0 - - 0 0 - - 0 0 - - 0 0 - - 0 0 - - 0 0 - - 2 1 - - 0 0 - - 0 0 - - 0 0 - - 0 0 - - 0 0 - - 0 0 
0 0 - - 0 0 - - 0 0 - - 0 0 - - 0 0 - - 0 0 - - 4 3 - - 0 0 - - 0 0 - - 0 0 - - 0 0 - - 0 0 - - 0 0 
0 0 0 0 x x 0 0 0 0 0 0 x x 0 0 0 0 0 0 x x 0 0 0 0 0 0 x x 0 0 0 0 0 0 x x 0 0 0 0 0 0 x x 0 0 0 0 
0 0 0 0 x x 0 0 0 0 0 0 x x 0 0 0 0 0 0 x x 0 0 0 0 0 0 x x 0 0 0 0 0 0 x x 0 0 0 0 0 0 x x 0 0 0 0 
0 0 - - 0 0 - - 0 0 - - 0 0 - - 0 0 - - 0 0 - - - - - - 0 0 - - 0 0 - - 0 0 - - 0 0 - - 0 0 - - 0 0 
0 0 - - 0 0 - - 0 0 - - 0 0 - - 0 0 - - 0 0 - - - - - - 0 0 - - 0 0 - - 0 0 - - 0 0 - - 0 0 - - 0 0 
0 0 - - 0 0 0 0 0 0 0 0 0 0 0 0 0 i 0 0 0 0 0 0 0 0 0 0 0 0 0 0 i 0 0 0 0 0 0 0 0 0 0 0 0 0 - - 0 0 
0 0 - - 0 0 0 0 0 0 0 0 0 0 0 0 i 0 0 0 0 0 0 0 0 0 0 0 0 0 0 0 0 i 0 0 0 0 0 0 0 0 0 0 0 0 - - 0 0 
0 0 - - 0 0 - - 0 0 - - 0 0 - - 0 0 - - 0 0 - - 0 0 - - 0 0 - - 0 0 - - 0 0 - - 0 0 - - 0 0 - - 0 0 
0 0 - - 0 0 - - 0 0 - - 0 0 - - 0 0 - - 0 0 - - 0 0 - - 0 0 - - 0 0 - - 0 0 - - 0 0 - - 0 0 - - 0 0 
0 0 0 0 x x 0 0 0 0 0 0 x x 0 0 0 0 0 0 x x 0 0 0 0 0 0 x x 0 0 0 0 0 0 x x 0 0 0 0 0 0 x x 0 0 0 0 
0 0 0 0 x x 0 0 0 0 0 0 x x 0 0 0 0 0 0 x x 0 0 0 0 0 0 x x 0 0 0 0 0 0 x x 0 0 0 0 0 0 x x 0 0 0 0 
0 0 - - 0 0 - - 0 0 - - 0 0 - - 0 0 - - 0 0 - - 0 0 - - 0 0 - - 0 0 - - 0 0 - - 0 0 - - 0 0 - - 0 0 
0 0 - - 0 0 - - 0 0 - - 0 0 - - 0 0 - - 0 0 - - 0 0 - - 0 0 - - 0 0 - - 0 0 - - 0 0 - - 0 0 - - 0 0 
0 0 - - 0 0 0 0 5 6 0 0 0 0 0 0 0 0 0 0 0 0 0 0 0 0 0 0 0 0 0 0 0 0 0 0 0 0 0 0 7 8 0 0 0 0 - - 0 0 
0 0 - - 0 0 0 0 6 5 0 0 0 0 0 0 0 0 0 0 0 0 0 0 0 0 0 0 0 0 0 0 0 0 0 0 0 0 0 0 8 7 0 0 0 0 - - 0 0 
0 0 - - 0 0 - - 0 0 - - 0 0 - - 0 0 - - 0 0 - - 0 0 - - 0 0 - - 0 0 - - 0 0 - - 0 0 - - 0 0 - - 0 0 
0 0 - - 0 0 - - 0 0 - - 0 0 - - 0 0 - - 0 0 - - 0 0 - - 0 0 - - 0 0 - - 0 0 - - 0 0 - - 0 0 - - 0 0 
0 0 - - x x 0 0 0 0 0 0 x x 0 0 0 0 0 0 x x 0 0 0 0 0 0 x x 0 0 0 0 0 0 x x 0 0 0 0 0 0 x x - - 0 0 
0 0 - - x x 0 0 0 0 0 0 x x 0 0 0 0 0 0 x x 0 0 0 0 0 0 x x 0 0 0 0 0 0 x x 0 0 0 0 0 0 x x - - 0 0 
0 0 - - - - - - - - - - 0 0 - - 0 0 - - - - - - 0 0 - - 0 0 - - - - - - 0 0 - - - - - - - - - - 0 0 
0 0 - - - - - - - - - - 0 0 - - 0 0 - - - - - - 0 0 - - 0 0 - - - - - - 0 0 - - - - - - - - - - 0 0 
b b 0 0 0 0 0 0 0 0 0 0 0 0 0 0 0 0 0 0 0 0 0 0 0 0 0 0 0 0 0 0 0 0 0 0 0 0 0 0 0 0 0 0 0 0 0 0 b b 
c b 0 0 0 0 0 0 0 0 0 0 0 0 0 0 0 0 0 0 0 0 0 0 0 0 0 0 0 0 0 0 0 0 0 0 0 0 0 0 0 0 0 0 0 0 0 0 b c 
