8
2
0 2
20 43
0 0 0 0 0 0 0 0 0 0 0 0 0 0 0 0 0 0 0 0 - - - 0 0 0 0 0 0 0 0 0 0 0 0 0 0 0 0 0 0 0 0
0 0 0 0 0 0 0 0 0 0 0 0 0 0 0 0 0 0 0 0 - - - 0 0 0 0 0 0 0 0 0 0 0 0 0 0 0 0 0 0 0 0
0 0 0 0 0 0 0 0 0 0 0 0 0 0 0 0 0 0 0 0 - - - 0 0 0 0 0 0 0 0 0 0 0 0 0 0 0 0 0 0 0 0
0 0 0 b 0 0 0 0 0 0 0 0 0 0 0 0 b 0 0 0 - - - 0 0 0 b 0 0 0 0 0 0 0 0 0 0 0 0 b 0 0 0
0 0 0 0 0 0 0 0 0 0 0 0 0 0 0 0 0 0 0 0 - - - 0 0 0 0 0 0 0 x x x x x x 0 0 0 0 0 0 0
0 0 0 0 0 0 0 0 0 1 2 0 0 0 0 0 0 0 0 0 - - - 0 0 0 0 0 0 0 x x x x x x 0 0 0 0 0 0 0
0 0 0 0 0 0 0 0 0 2 1 0 0 0 0 0 0 0 0 0 - - - 0 0 0 0 0 0 0 0 0 0 0 0 0 0 0 0 0 0 0 0
0 0 0 0 x x 0 0 0 0 0 0 0 0 x x 0 0 0 0 - - - 0 0 0 0 0 0 0 0 0 0 0 0 0 0 0 0 0 0 0 0
0 0 0 0 x x 0 0 - - - - 0 0 x x 0 0 0 0 - - - 0 0 0 0 0 0 0 0 - - - - 0 0 0 0 0 0 0 0
0 0 0 0 x x 0 0 - - - - 0 0 x x 0 0 0 0 - - - 0 0 0 0 0 5 6 0 - - - - 0 7 8 0 0 0 0 0
0 0 0 0 x x 0 0 - - - - 0 0 x x 0 0 0 0 - - - 0 0 0 0 0 6 5 0 - - - - 0 8 7 0 0 0 0 0
0 0 0 0 x x 0 0 - - - - 0 0 x x 0 0 0 0 - - - 0 0 0 0 0 0 0 0 - - - - 0 0 0 0 0 0 0 0
0 0 0 0 x x 0 0 0 0 0 0 0 0 x x 0 0 0 0 - - - 0 0 0 0 0 0 0 0 0 0 0 0 0 0 0 0 0 0 0 0
0 0 0 0 0 0 0 0 0 3 4 0 0 0 0 0 0 0 0 0 - - - 0 0 0 0 0 0 0 0 0 0 0 0 0 0 0 0 0 0 0 0
0 0 0 0 0 0 0 0 0 4 3 0 0 0 0 0 0 0 0 0 - - - 0 0 0 0 0 0 0 x x x x x x 0 0 0 0 0 0 0
0 0 0 0 0 0 0 0 0 0 0 0 0 0 0 0 0 0 0 0 - - - 0 0 0 0 0 0 0 x x x x x x 0 0 0 0 0 0 0
0 0 0 b 0 0 0 0 0 0 0 0 0 0 0 0 b 0 0 0 - - - 0 0 0 b 0 0 0 0 0 0 0 0 0 0 0 0 b 0 0 0
0 0 0 0 0 0 0 0 0 0 0 0 0 0 0 0 0 0 0 0 - - - 0 0 0 0 0 0 0 0 0 0 0 0 0 0 0 0 0 0 0 0
0 0 0 0 0 0 0 0 0 0 0 0 0 0 0 0 0 0 0 0 - - - 0 0 0 0 0 0 0 0 0 0 0 0 0 0 0 0 0 0 0 0
0 0 0 0 0 0 0 0 0 0 0 0 0 0 0 0 0 0 0 0 - - - 0 0 0 0 0 0 0 0 0 0 0 0 0 0 0 0 0 0 0 0
7 7 3 <-> 35 12 7
7 12 1 <-> 35 7 5 
12 7 5 <-> 30 12 1
12 12 7 <-> 30 7 3
31 12 0 <-> 8 7 4
31 12 1 <-> 9 7 5
32 12 7 <-> 8 7 3
32 12 0 <-> 9 7 4
32 12 1 <-> 10 7 5
33 12 7 <-> 9 7 3
33 12 0 <-> 10 7 4
33 12 1 <-> 11 7 5
34 12 7 <-> 10 7 3
34 12 0 <-> 11 7 4
8 12 0 <-> 31 7 4
8 12 1 <-> 32 7 5
9 12 7 <-> 31 7 3
9 12 0 <-> 32 7 4
9 12 1 <-> 33 7 5
10 12 7 <-> 32 7 3
10 12 0 <-> 33 7 4
10 12 1 <-> 34 7 5
11 12 7 <-> 33 7 3
11 12 0 <-> 34 7 4
30 8 2 <-> 12 8 6
30 8 3 <-> 12 9 7
30 9 1 <-> 12 8 5
30 9 2 <-> 12 9 6
30 9 3 <-> 12 10 7
30 10 1 <-> 12 9 5
30 10 2 <-> 12 10 6
30 10 3 <-> 12 11 7
30 11 1 <-> 12 10 5
30 11 2 <-> 12 11 6
7 8 2 <-> 35 8 6
7 8 3 <-> 35 9 7
7 9 1 <-> 35 8 5
7 9 2 <-> 35 9 6
7 9 3 <-> 35 10 7
7 10 1 <-> 35 9 5
7 10 2 <-> 35 10 6
7 10 3 <-> 35 11 7
7 11 1 <-> 35 10 5
7 11 2 <-> 35 11 6