8
1
1 1
22 22
b - - - - - - - - - - b - - - - - - - - - -
- 0 0 0 0 0 0 0 0 0 0 - 0 0 0 0 0 0 0 0 0 0
- 0 0 0 0 0 0 0 0 0 0 - 0 0 0 0 0 0 0 0 0 0
- 0 0 0 0 0 0 0 0 0 0 - 0 0 0 0 0 0 0 0 0 0
- 0 0 0 0 0 0 0 0 0 0 - 0 0 0 0 0 0 0 0 0 0
- 0 0 0 0 1 2 0 0 0 0 - 0 0 0 0 3 4 0 0 0 0
- 0 0 0 0 2 1 0 0 0 0 - 0 0 0 0 4 3 0 0 0 0
- 0 0 0 0 0 0 0 0 0 0 - 0 0 0 0 0 0 0 0 0 0
- 0 0 0 0 0 0 0 0 0 0 - 0 0 0 0 0 0 0 0 0 0
- 0 0 0 0 0 0 0 0 0 0 - 0 0 0 0 0 0 0 0 0 0
- 0 0 0 0 0 0 0 0 0 0 - 0 0 0 0 0 0 0 0 0 0
b - - - - - - - - - - b - - - - - - - - - -
- 0 0 0 0 0 0 0 0 0 0 - 0 0 0 0 0 0 0 0 0 0
- 0 0 0 0 0 0 0 0 0 0 - 0 0 0 0 0 0 0 0 0 0
- 0 0 0 0 0 0 0 0 0 0 - 0 0 0 0 0 0 0 0 0 0
- 0 0 0 0 0 0 0 0 0 0 - 0 0 0 0 0 0 0 0 0 0
- 0 0 0 0 5 6 0 0 0 0 - 0 0 0 0 7 8 0 0 0 0
- 0 0 0 0 6 5 0 0 0 0 - 0 0 0 0 8 7 0 0 0 0
- 0 0 0 0 0 0 0 0 0 0 - 0 0 0 0 0 0 0 0 0 0
- 0 0 0 0 0 0 0 0 0 0 - 0 0 0 0 0 0 0 0 0 0
- 0 0 0 0 0 0 0 0 0 0 - 0 0 0 0 0 0 0 0 0 0
- 0 0 0 0 0 0 0 0 0 0 - 0 0 0 0 0 0 0 0 0 0
0 0 1 <-> 1 21 5
0 0 5 <-> 21 1 1
0 0 7 <-> 21 21 3
11 0 1 <-> 12 21 5 
11 0 7 <-> 21 10 3
0 11 5 <-> 21 12 1
0 11 7 <-> 10 21 3 

