8
4
4 2
34 34
- - - - - - - - - - - - - 0 0 0 0 0 0 0 0 - - - - - - - - - - - - -
- 0 0 0 0 0 - - - - - - - 0 0 0 0 0 0 0 0 - - - - - - - - - - - - -
- 0 0 0 0 0 - - - - - - - 0 0 0 0 0 0 0 0 - - - - - - - - - - - - -
- 0 0 i 0 0 - - - - - - - 0 0 0 2 1 0 0 0 - - - - - - - - - - - - -
- 0 0 0 0 0 - - - - - - - 0 0 0 1 2 0 0 0 - - - - - - - - - - - - -
- 0 0 0 0 0 - - - - - - - 0 0 0 0 0 0 0 0 - - - - - - - - - - - - -
- - - - - - - - - - - - - 0 0 0 0 0 0 0 0 - - - - - - - - - - - - -
- - - - - - - - - - - - - 0 0 0 0 0 0 0 0 - - - - - - - - - - - - -
- - - - - - - - 0 0 x 0 0 0 0 0 - - 0 0 0 0 0 x 0 0 - - - - - - - -
- - - - - - - - 0 x 0 0 0 0 0 0 0 0 0 0 0 0 0 0 x 0 - - - - - - - -
- - - - - - - - x 0 0 0 0 0 0 0 0 0 0 0 0 0 0 0 0 x - - - - - - - -
- - - - - - - - 0 0 0 - - 0 0 0 0 0 0 0 0 - - 0 0 0 - - - - - - - -
- - - - - - - - 0 0 0 - - 0 0 0 0 0 0 0 0 - - 0 0 0 - - - - - - - -
0 0 0 0 0 0 0 0 0 0 0 0 0 b 0 0 0 0 0 0 c 0 0 0 0 0 0 0 0 0 0 0 0 0
0 0 0 0 0 0 0 0 0 0 0 0 0 0 0 0 0 0 0 0 0 0 0 0 0 0 0 0 0 0 0 0 0 0
0 0 0 0 0 0 0 0 0 0 0 0 0 0 0 - 0 0 - 0 0 0 0 0 0 0 0 0 0 0 0 0 0 0
0 0 0 7 8 0 0 0 - 0 0 0 0 0 0 0 c b 0 0 0 0 0 0 0 - 0 0 0 3 4 0 0 0
0 0 0 8 7 0 0 0 - 0 0 0 0 0 0 0 b c 0 0 0 0 0 0 0 - 0 0 0 4 3 0 0 0
0 0 0 0 0 0 0 0 0 0 0 0 0 0 0 - 0 0 - 0 0 0 0 0 0 0 0 0 0 0 0 0 0 0
0 0 0 0 0 0 0 0 0 0 0 0 0 0 0 0 0 0 0 0 0 0 0 0 0 0 0 0 0 0 0 0 0 0
0 0 0 0 0 0 0 0 0 0 0 0 0 c 0 0 0 0 0 0 b 0 0 0 0 0 0 0 0 0 0 0 0 0
- - - - - - - - 0 0 0 - - 0 0 0 0 0 0 0 0 - - 0 0 0 - - - - - - - -
- - - - - - - - 0 0 0 - - 0 0 0 0 0 0 0 0 - - 0 0 0 - - - - - - - -
- - - - - - - - x 0 0 0 0 0 0 0 0 0 0 0 0 0 0 0 0 x - - - - - - - -
- - - - - - - - 0 x 0 0 0 0 0 0 0 0 0 0 0 0 0 0 x 0 - - - - - - - -
- - - - - - - - 0 0 x 0 0 0 0 0 - - 0 0 0 0 0 x 0 0 - - - - - - - -
- - - - - - - - - - - - - 0 0 0 0 0 0 0 0 - - - - - - - - - - - - -
- - - - - - - - - - - - - 0 0 0 0 0 0 0 0 - - - - - - - - - - - - -
- - - - - - - - - - - - - 0 0 0 0 0 0 0 0 - - - - - - - 0 0 0 0 0 -
- - - - - - - - - - - - - 0 0 0 6 5 0 0 0 - - - - - - - 0 0 0 0 0 -
- - - - - - - - - - - - - 0 0 0 5 6 0 0 0 - - - - - - - 0 0 i 0 0 -
- - - - - - - - - - - - - 0 0 0 0 0 0 0 0 - - - - - - - 0 0 0 0 0 -
- - - - - - - - - - - - - 0 0 0 0 0 0 0 0 - - - - - - - 0 0 0 0 0 -
- - - - - - - - - - - - - 0 0 0 0 0 0 0 0 - - - - - - - - - - - - -
10 11 2 <-> 33 15 2
10 12 2 <-> 33 16 2
10 21 2 <-> 33 17 2
10 22 2 <-> 33 18 2
11 10 4 <-> 15 33 4
11 13 0 <-> 4 5 4
11 20 4 <-> 31 28 0
11 23 0 <-> 15 0 0
12 10 4 <-> 16 33 4
12 13 0 <-> 5 5 4
12 20 4 <-> 32 28 0
12 23 0 <-> 16 0 0
13 11 6 <-> 5 4 2
13 12 6 <-> 5 5 2
13 21 6 <-> 32 28 2
13 22 6 <-> 32 29 2
20 11 2 <-> 28 31 6
20 12 2 <-> 28 32 6
20 21 2 <-> 1 1 6
20 22 2 <-> 1 2 6
21 10 4 <-> 17 33 4
21 13 0 <-> 28 32 4
21 20 4 <-> 1 1 0
21 23 0 <-> 17 0 0
22 10 4 <-> 18 33 4
22 13 0 <-> 29 32 4
22 20 4 <-> 2 1 0
22 23 0 <-> 18 0 0
23 11 6 <-> 0 15 6
23 12 6 <-> 0 16 6
23 21 6 <-> 0 17 6
23 22 6 <-> 0 18 6
