8
12
6 2
30 30
- - - - - 0 0 0 0 0 0 0 0 0 0 0 0 0 0 0 - - - - - - - - - -
- - - - - 0 0 i b 0 0 0 0 0 i b 0 0 0 0 - - - - - - - - - -
- - - - - 0 0 0 0 0 0 0 8 1 5 6 2 0 0 0 - - - - - - - - - -
- - - - - 0 0 0 0 0 0 0 7 8 1 2 3 0 0 0 - - - - - - - - - -
- - - - - 0 0 0 0 0 0 0 6 7 3 4 5 0 0 0 - - - - - - - - - -
- - - - - 0 0 i b 0 0 0 0 5 i b 4 0 0 0 - - - - - - - - - -
- - - - - 0 0 0 0 0 0 0 0 0 0 0 0 0 0 0 - - - - - - - - - -
- - - - - 0 0 0 0 0 0 0 0 0 0 0 0 0 0 0 - - - - - - - - - -
- - - - - 0 0 0 0 0 0 c 0 0 0 0 0 0 0 0 - - - - - - - - - -
- - - - - 0 0 0 0 0 0 0 0 0 0 0 0 0 0 0 - - - - - - - - - -
- - - - - 0 0 0 0 0 0 0 0 0 0 0 0 0 0 0 - - - - - - - - - -
- - - - - 0 0 0 0 0 0 0 0 0 0 0 0 0 0 0 - - - - - - - - - -
- - - - - 0 0 0 0 0 0 0 0 0 0 0 0 0 0 0 - - - - - - - - - -
- - - - - 0 0 i b 0 0 0 0 0 i b 0 0 0 0 - - - - - - - - - -
- - - - - 0 0 0 0 0 0 0 0 0 0 0 0 0 0 0 - - - - - - - - - -
- - - - - 0 0 0 0 0 0 0 0 0 0 0 0 0 0 0 - - - - - - - - - -
- - - - - 0 0 0 0 0 0 c 0 0 0 0 0 0 0 0 - - - - - - - - - -
- - - - - 0 0 0 0 0 0 0 0 0 0 0 0 0 0 0 - - - - - - - - - -
- - - - - 0 0 0 0 0 0 0 0 0 0 0 0 0 0 0 - - - - - - - - - -
- - - - - 0 0 i b 0 0 0 0 0 i b 0 0 0 0 - - - - - - - - - -
- - - - - 0 0 0 0 0 0 0 0 0 0 0 0 0 0 0 - - - - - - - - - -
- - - - - 0 0 0 0 0 0 0 0 0 0 0 0 0 0 0 - - - - - - - - - -
- - - - - 0 0 0 0 0 0 c 0 0 0 0 0 0 0 0 - - - - - - - - - -
- - - - - 0 0 0 0 0 0 0 0 0 0 0 0 0 0 0 - - - - - - - - - -
- - - - - 0 0 0 0 0 0 0 0 0 0 0 0 0 0 0 - - - - - - - - - -
- - - - - 0 0 i b 0 0 0 0 0 i b 0 0 0 0 - - - - - - - - - -
- - - - - 0 0 0 0 0 0 0 0 0 0 0 0 0 0 0 - - - - - - - - - -
- - - - - 0 0 0 0 0 0 0 0 0 0 0 0 0 0 0 - - - - - - - - - -
- - - - - 0 0 0 0 0 0 c 0 0 0 0 0 0 0 0 - - - - - - - - - -
- - - - - 0 0 i b 0 0 0 0 0 i b 0 0 0 0 - - - - - - - - - -
5 0 0 <-> 19 29 4
6 0 0 <-> 18 29 4
7 0 0 <-> 17 29 4
8 0 0 <-> 16 29 4
9 0 0 <-> 15 29 4
10 0 0 <-> 14 29 4
11 0 0 <-> 13 29 4
12 0 0 <-> 12 29 4
13 0 0 <-> 11 29 4
14 0 0 <-> 10 29 4
15 0 0 <-> 9 29 4
16 0 0 <-> 8 29 4
17 0 0 <-> 7 29 4
18 0 0 <-> 6 29 4
19 0 0 <-> 5 29 4
5 0 1 <-> 18 29 3
6 0 1 <-> 17 29 3
7 0 1 <-> 16 29 3
8 0 1 <-> 15 29 3
9 0 1 <-> 14 29 3
10 0 1 <-> 13 29 3
11 0 1 <-> 12 29 3
12 0 1 <-> 11 29 3
13 0 1 <-> 10 29 3
14 0 1 <-> 9 29 3
15 0 1 <-> 8 29 3
16 0 1 <-> 7 29 3
17 0 1 <-> 6 29 3
18 0 1 <-> 5 29 3
6 0 7 <-> 19 29 5
7 0 7 <-> 18 29 5
8 0 7 <-> 17 29 5
9 0 7 <-> 16 29 5
10 0 7 <-> 15 29 5
11 0 7 <-> 14 29 5
12 0 7 <-> 13 29 5
13 0 7 <-> 12 29 5
14 0 7 <-> 11 29 5
15 0 7 <-> 10 29 5
16 0 7 <-> 9 29 5
17 0 7 <-> 8 29 5
18 0 7 <-> 7 29 5
19 0 7 <-> 6 29 5
