8
0
0 0
24 24
- 0 0 - 0 - 0 0 0 - - 0 0 0 0 - 0 0 0 - - 0 - 0
0 - 0 0 - 0 0 0 - 0 0 0 0 0 - 0 0 - 0 0 0 0 0 0
0 - 0 0 0 0 - 0 0 0 0 0 - 0 0 - 0 0 0 0 - 0 - 0
0 0 0 - 0 0 0 0 - - 0 0 - 0 0 0 0 0 - 0 0 0 0 -
0 0 0 - 0 0 - 0 0 0 0 - 0 0 - 0 - 0 0 0 - - 0 0
0 - 0 0 - 0 0 0 - 0 0 - 0 - 0 - 0 0 - 0 0 0 0 0
0 0 0 - 0 0 0 0 0 0 0 0 0 0 - 0 0 0 0 - 0 - 0 0
0 0 0 0 0 0 - 0 0 0 - - 0 - 0 0 - - 0 0 0 - 0 0
0 - 0 0 0 - - 0 0 0 0 0 0 0 0 0 0 0 0 - 0 0 0 -
0 0 0 - 0 0 0 0 0 1 2 0 0 4 3 0 - 0 0 0 - 0 0 0
- 0 0 - 0 0 0 - 0 2 1 0 0 3 4 0 0 0 0 0 0 - 0 0
0 0 - 0 0 0 0 0 0 0 0 0 0 0 0 0 0 - 0 - 0 0 - 0
- 0 0 - 0 0 0 - 0 0 0 0 0 0 0 0 - 0 0 0 0 0 0 0
- 0 0 - 0 - - 0 0 6 5 0 0 7 8 0 0 0 0 0 - 0 - 0
0 0 - 0 0 - 0 - 0 5 6 0 0 8 7 0 - 0 0 0 - 0 0 0
- 0 0 0 0 0 0 0 0 0 0 0 0 0 0 0 0 0 0 0 0 - 0 0
- 0 0 - 0 0 0 0 - 0 - 0 0 0 0 - 0 0 0 0 - 0 0 0
0 0 0 0 0 - 0 0 0 0 0 - 0 0 - 0 0 0 0 - 0 0 0 0
- 0 0 0 - 0 0 0 0 0 - - 0 0 0 0 0 - 0 0 0 0 - -
0 0 0 0 0 0 - 0 0 0 0 - 0 0 0 - 0 0 0 0 0 0 0 0
- 0 0 - 0 0 0 0 - 0 0 0 0 0 0 0 - - 0 0 0 0 0 0
- - 0 0 0 0 0 0 - - - 0 0 0 - 0 0 0 0 0 0 - 0 0
0 0 0 0 - - 0 0 0 0 0 0 0 0 0 0 0 - 0 0 0 0 0 0
0 0 0 - - 0 - 0 0 0 0 - - - 0 0 0 0 0 0 0 0 - -
