8
8
3 2
39 25
1 2 0 0 0 0 0 0 0 0 0 0 0 0 0 0 0 0 0 0 0 0 0 3 4
2 1 0 0 0 0 0 0 0 0 0 0 0 0 0 0 0 0 0 0 0 0 0 4 3
0 0 0 0 0 0 0 0 0 0 0 0 0 0 0 0 0 0 0 0 0 0 0 0 0
0 0 0 0 - - - - 0 0 - - - - - 0 0 - 0 c 0 - 0 0 0
0 0 0 - 0 0 0 0 0 0 - 0 b 0 - 0 0 - - 0 0 - 0 0 0
0 0 0 - 0 c 0 0 0 0 - - - - - 0 0 - 0 - 0 - 0 0 0
0 0 0 - 0 0 0 0 0 0 - 0 0 0 - 0 0 - 0 0 - - 0 0 0
0 0 0 0 - - - - 0 0 - 0 0 0 - 0 0 - 0 0 0 - 0 0 0
0 0 0 0 0 0 0 0 0 0 0 0 i 0 0 0 0 0 0 0 0 0 0 0 0
0 0 0 0 0 0 0 0 0 0 0 0 0 0 0 0 0 0 0 0 0 0 0 0 0
0 0 0 - 0 0 0 - 0 0 - - - - - 0 0 - 0 0 0 - 0 0 0
0 0 0 0 - 0 - 0 0 0 - 0 0 0 - 0 0 - 0 0 0 - 0 0 0
0 0 0 0 0 - 0 0 0 0 - 0 b 0 - 0 0 - 0 b 0 - 0 0 0
0 0 0 0 0 - 0 0 0 0 - 0 0 0 - 0 0 - 0 0 0 - 0 0 0
0 0 0 0 0 - 0 0 0 0 - - - - - 0 0 - - - - - 0 0 0
0 i 0 0 0 0 0 0 0 0 0 0 0 0 0 0 0 0 0 0 0 0 0 0 0
0 0 0 0 0 0 0 0 0 0 0 0 0 0 0 0 0 0 0 0 0 0 0 0 0
0 0 0 - - - - 0 - - - - 0 - - - - 0 - - - - 0 0 0
0 0 0 - 0 b - 0 - 0 0 0 0 - 0 0 - 0 0 - - 0 0 0 0
0 0 0 - - - 0 0 - - 0 0 0 - - - - 0 0 - - 0 0 0 0
0 0 0 - b 0 - 0 - 0 c 0 0 - 0 0 - 0 0 - - 0 0 0 0
0 0 0 - - - - 0 - - - - 0 - 0 0 - 0 0 - - 0 0 0 0
0 0 0 0 0 0 0 0 0 0 0 0 0 0 0 0 0 0 i 0 0 0 0 0 0
0 0 0 0 0 0 0 0 0 0 0 0 0 0 0 0 0 0 0 0 0 0 0 0 0
0 0 0 - - - - 0 - 0 0 - 0 0 - - 0 0 - - - - 0 0 0
0 0 0 0 - - 0 0 - 0 0 - 0 0 - - 0 0 - 0 0 0 0 0 0
0 0 0 0 - - 0 0 - - - - 0 0 - - 0 0 - - - - 0 0 0
0 0 0 0 - - 0 0 - 0 0 - 0 0 - - 0 0 0 0 0 - 0 0 0
0 0 0 0 - - 0 0 - 0 0 - 0 0 - - 0 0 - - - - 0 0 0
0 0 0 0 0 0 0 0 0 0 0 0 0 0 0 0 0 0 0 0 0 0 0 0 0
0 0 0 0 0 0 0 0 0 0 0 0 0 0 0 0 0 0 0 0 0 0 0 0 0
0 0 0 - 0 0 0 - 0 - - - - 0 - - - - 0 - - - 0 0 0
0 0 0 - - 0 - - 0 - 0 b - 0 - b 0 - 0 0 0 - 0 0 0
0 0 0 - 0 - 0 - 0 - - - - 0 - - - - 0 0 - 0 0 0 0
0 0 0 - 0 i 0 - 0 - 0 0 - 0 - 0 0 0 0 0 c 0 0 0 0
0 0 0 - 0 0 0 - 0 - 0 0 - 0 - 0 0 0 0 0 - 0 0 0 0
0 0 0 0 0 0 0 0 0 0 0 0 0 0 0 0 0 0 0 0 0 0 0 0 0
5 6 0 0 0 0 0 0 0 0 0 0 0 0 0 0 0 0 0 0 0 0 0 7 8
6 5 0 0 0 0 0 0 0 0 0 0 0 0 0 0 0 0 0 0 0 0 0 8 7
9 4 2 <-> 11 4 6
13 4 2 <-> 15 4 6
9 11 2 <-> 11 11 6
13 11 2 <-> 15 11 6
9 12 2 <-> 11 12 6
13 12 2 <-> 15 12 6
9 13 2 <-> 11 13 6
13 13 2 <-> 15 13 6
2 18 2 <-> 4 18 6
5 18 2 <-> 7 18 6
12 18 2 <-> 14 18 6
15 18 2 <-> 17 18 6
2 20 2 <-> 4 20 6
5 20 2 <-> 7 20 6
8 32 2 <-> 10 32 6
11 32 2 <-> 13 32 6
13 32 2 <-> 15 32 6
16 32 2 <-> 18 32 6
