8
3
0 2
21 21
- - - - - - - - - - 0 - - - - - - - - - - 
- - - - - - - - - 0 0 0 - - - - - - - - - 
- - - - - - - - 0 0 b 0 0 - - - - - - - - 
- - - - - - - 0 0 0 0 0 0 0 - - - - - - - 
- - - - - - 0 0 0 0 i 0 0 0 0 - - - - - - 
- - - - - 0 0 0 0 0 0 0 0 0 0 0 - - - - - 
- - - - 0 0 1 5 0 0 b 0 0 2 6 0 0 - - - - 
- - - 0 0 0 5 1 0 0 0 0 0 6 2 0 0 0 - - - 
- - 0 0 0 0 0 0 0 0 x 0 0 0 0 0 0 0 0 - - 
- 0 0 0 0 0 0 0 0 x 0 x 0 0 0 0 0 0 0 0 - 
0 0 b 0 i 0 b 0 x 0 b 0 x 0 b 0 i 0 b 0 0 
- 0 0 0 0 0 0 0 0 x 0 x 0 0 0 0 0 0 0 0 - 
- - 0 0 0 0 0 0 0 0 x 0 0 0 0 0 0 0 0 - - 
- - - 0 0 0 3 7 0 0 0 0 0 4 8 0 0 0 - - - 
- - - - 0 0 7 3 0 0 b 0 0 8 4 0 0 - - - - 
- - - - - 0 0 0 0 0 0 0 0 0 0 0 - - - - - 
- - - - - - 0 0 0 0 i 0 0 0 0 - - - - - - 
- - - - - - - 0 0 0 0 0 0 0 - - - - - - - 
- - - - - - - - 0 0 b 0 0 - - - - - - - - 
- - - - - - - - - 0 0 0 - - - - - - - - - 
- - - - - - - - - - 0 - - - - - - - - - - 
10 0 0 <-> 10 20 4
0 10 6 <-> 20 10 2
10 0 7 <-> 10 0 1
20 10 1 <-> 20 10 3
10 20 5 <-> 10 20 3
0 10 7 <-> 0 10 5
