8
15
1 2
24 24
7 5 6 1 6 7 4 1 4 2 8 1 4 7 6 1 7 5 6 1 4 2 8 1
8 3 4 2 2 3 6 5 1 6 5 7 1 3 2 5 8 3 4 2 6 6 5 7
6 7 2 8 8 1 5 3 2 8 3 5 2 1 8 3 6 7 2 8 5 8 3 5
4 1 3 5 7 2 8 4 7 3 6 4 7 2 7 4 4 1 3 5 8 3 6 4
4 5 6 8 1 4 7 5 7 5 6 1 7 4 1 5 4 5 6 8 7 5 6 1
1 6 7 3 6 8 2 4 8 3 4 2 8 8 6 4 1 6 7 3 2 3 4 2
2 8 5 4 3 2 1 8 6 7 2 8 6 2 3 8 2 8 5 4 1 7 2 8
7 1 3 2 7 5 6 3 4 1 3 5 4 5 7 3 7 1 3 2 6 1 3 5
6 7 4 1 4 2 8 1 4 5 6 8 4 2 4 1 6 7 4 1 8 5 6 8
2 3 6 5 1 6 5 7 1 6 7 3 1 6 1 7 2 3 6 5 5 6 7 3
8 1 5 3 2 8 3 5 2 8 5 4 2 8 2 5 8 1 5 3 3 8 5 4
7 2 8 4 7 3 6 4 7 1 3 2 7 3 7 4 7 2 8 4 6 1 3 2
6 7 4 1 4 2 8 1 4 5 6 8 4 2 4 1 6 7 4 1 8 5 6 8
1 6 7 3 6 8 2 4 8 3 4 2 8 8 6 4 1 6 7 3 2 3 4 2
7 5 6 1 6 7 4 1 4 2 8 1 4 7 6 1 7 5 6 1 4 2 8 1
4 1 3 5 7 2 8 4 7 3 6 4 7 2 7 4 4 1 3 5 8 3 6 4
4 5 6 8 1 4 7 5 7 5 6 1 7 4 1 5 4 5 6 8 7 5 6 1
2 8 5 4 3 2 1 8 6 7 2 8 6 2 3 8 2 8 5 4 1 7 2 8
7 1 3 2 7 5 6 3 4 1 3 5 4 5 7 3 7 1 3 2 6 1 3 5
6 7 2 8 8 1 5 3 2 8 3 5 2 1 8 3 6 7 2 8 5 8 3 5
8 3 4 2 2 3 6 5 1 6 5 7 1 3 2 5 8 3 4 2 6 6 5 7
2 3 6 5 1 6 5 7 1 6 7 3 1 6 1 7 2 3 6 5 5 6 7 3
8 1 5 3 2 8 3 5 2 8 5 4 2 8 2 5 8 1 5 3 3 8 5 4
7 2 8 4 7 3 6 4 7 1 3 2 7 3 7 4 7 2 8 4 6 1 3 2
