8
23
0 0
12 12
7 5 6 1 - - - - 4 2 8 1 
8 3 4 2 - - - - 1 6 5 7 
6 7 2 8 - - - - 2 8 3 5 
4 1 3 5 - - - - 7 3 6 4 
- - - - 1 4 7 5 - - - - 
- - - - 6 8 2 4 - - - - 
- - - - 3 2 1 8 - - - - 
- - - - 7 5 6 3 - - - - 
6 7 4 1 - - - - 4 5 6 8 
2 3 6 5 - - - - 1 6 7 3 
8 1 5 3 - - - - 2 8 5 4 
7 2 8 4 - - - - 7 1 3 2 
3 0 1 <-> 8 11 5
3 11 3 <-> 8 0 7
11 3 3 <-> 0 8 7
0 3 5 <-> 11 8 1
