8
4
0 1
38 50
0 0 0 0 0 0 0 0 - 0 0 0 0 0 0 - - - - - - - - - - - - - - - - - - - - 0 0 0 0 0 0 - 0 0 0 0 0 0 0 0 
0 0 0 0 0 0 0 0 - 0 0 0 0 0 0 - 0 0 0 0 0 0 0 0 0 0 0 0 0 0 0 0 0 0 - 0 0 0 0 0 0 - 0 0 0 0 0 0 0 0 
0 0 0 0 0 0 0 0 - 0 0 0 0 0 0 - 0 - - - 0 - - - - 0 - - - 0 - 0 - 0 - 0 0 0 0 0 0 - 0 0 0 0 0 0 0 0 
0 0 0 3 4 0 0 0 - 0 0 0 0 0 0 - 0 - 0 0 0 - 0 0 - 0 - 0 0 0 - 0 - 0 - 0 0 0 0 0 0 - 0 0 0 5 6 0 0 0 
0 0 0 4 3 0 0 0 - 0 0 0 0 0 0 - 0 - - 0 0 - - - - 0 - - - 0 - - - 0 - 0 0 0 0 0 0 - 0 0 0 6 5 0 0 0 
0 0 0 0 0 0 0 0 - 0 0 0 0 0 0 - 0 - 0 0 0 - 0 0 - 0 0 0 - 0 0 - 0 0 - 0 0 0 0 0 0 - 0 0 0 0 0 0 0 0 
0 0 0 0 0 0 0 0 - 0 0 0 0 0 0 - 0 - - - 0 - 0 0 - 0 - - - 0 0 - 0 0 - 0 0 0 0 0 0 - 0 0 0 0 0 0 0 0 
0 0 0 0 0 0 0 0 - 0 0 0 0 0 0 - 0 0 0 0 0 0 0 0 0 0 0 0 0 0 0 0 0 0 - 0 0 0 0 0 0 - 0 0 0 0 0 0 0 0 
- - - - - - - - - - - - - - - - - - - - - - - - - - - - - - - - - - - - - - - - - - - - - - - - - - 
- - - - - - - - - 0 0 0 0 0 0 0 0 - 0 0 0 0 0 0 0 0 0 0 0 0 0 0 - 0 0 0 0 0 0 0 0 - - - - - - - - - 
- - - - - - - - - 0 0 0 0 0 0 0 0 - 0 0 0 0 0 0 0 0 0 0 0 0 0 0 - 0 0 0 0 0 0 0 0 - - - - - - - - - 
- - - - - - - - - 0 0 0 0 0 0 0 0 - 0 0 0 0 0 0 0 0 0 0 0 0 0 0 - 0 0 0 0 0 0 0 0 - - - - - - - - - 
- - - - - - - - - 0 0 0 0 0 0 0 0 - 0 0 0 0 b b b 0 0 b b b 0 0 - 0 0 0 0 0 0 0 0 - - - - - - - - - 
- - - - - - - - - 0 0 0 0 0 0 0 0 - 0 0 0 0 - - - 0 0 - - - 0 0 - 0 0 0 0 0 0 0 0 - - - - - - - - - 
- - - - - - - - - 0 0 0 0 0 0 0 0 - 0 0 0 0 0 0 0 0 0 0 0 0 0 0 - 0 0 0 0 0 0 0 0 - - - - - - - - - 
- - - b 0 0 0 0 0 0 0 0 0 0 0 0 0 - 0 0 0 0 - - - 0 0 0 0 0 0 0 - 0 0 0 0 0 0 0 0 0 0 0 0 0 b - - - 
- - i - - - - - 0 0 0 0 0 0 0 0 0 - 0 0 0 0 - - - 0 0 - - - 0 0 - 0 0 0 0 0 0 0 0 0 - - - - - i - - 
- 0 - - - - - - - - - - - - - - - - 0 0 0 0 - - - 0 0 0 0 0 0 0 - - - - - - - - - - - - - - - - 0 - 
- 0 - - - - - - - - - - - - - - - - 0 0 0 0 0 0 0 0 0 0 0 0 0 0 - - - - - - - - - - - - - - - - 0 - 
- 0 - - - - - - - - - - - - - - - - 0 0 0 0 0 0 0 0 0 0 0 0 0 0 - - - - - - - - - - - - - - - - 0 - 
- 0 - - - - - - - - - - - - - - - - 0 0 0 0 0 0 0 0 0 0 0 - 0 0 - - - - - - - - - - - - - - - - 0 - 
- - i - - - - - 0 0 0 0 0 0 0 0 0 - 0 0 0 - 0 0 0 0 0 0 0 - 0 0 - 0 0 0 0 0 0 0 0 0 - - - - - i - - 
- - - b 0 0 0 0 0 0 0 0 0 0 0 0 0 - 0 0 0 - 0 0 0 0 0 0 0 - 0 0 - 0 0 0 0 0 0 0 0 0 0 0 0 0 b - - - 
- - - - - - - - - 0 0 0 0 0 0 0 0 - 0 0 0 - - - - - - - - - 0 0 - 0 0 0 0 0 0 0 0 - - - - - - - - - 
- - - - - - - - - 0 0 0 0 0 0 0 0 - 0 0 0 0 0 0 0 0 0 0 0 0 0 0 - 0 0 0 0 0 0 0 0 - - - - - - - - - 
- - - - - - - - - 0 0 0 0 0 0 0 0 - 0 0 0 0 0 0 0 0 0 0 0 0 0 0 - 0 0 0 0 0 0 0 0 - - - - - - - - - 
- - - - - - - - - 0 0 0 0 0 0 0 0 - 0 0 0 0 0 0 0 0 0 0 0 0 0 0 - 0 0 0 0 0 0 0 0 - - - - - - - - - 
- - - - - - - - - 0 0 0 0 0 0 0 0 - 0 0 0 0 0 0 0 0 0 0 0 0 0 0 - 0 0 0 0 0 0 0 0 - - - - - - - - - 
- - - - - - - - - 0 0 0 0 0 0 0 0 - 0 0 0 0 0 0 0 0 0 0 0 0 0 0 - 0 0 0 0 0 0 0 0 - - - - - - - - - 
- - - - - - - - - - - - - - - - - - - - - - - - - - - - - - - - - - - - - - - - - - - - - - - - - - 
0 0 0 0 0 0 0 0 - 0 0 0 0 0 0 0 0 0 0 0 - - 0 0 0 0 0 0 - - 0 0 0 0 0 0 0 0 0 0 0 - 0 0 0 0 0 0 0 0 
0 0 0 0 0 0 0 0 - 0 0 0 0 0 0 0 0 0 0 0 - - 0 0 0 0 0 0 - - 0 0 0 0 0 0 0 0 0 0 0 - 0 0 0 0 0 0 0 0 
0 0 0 0 0 0 0 0 - 0 0 0 0 0 0 0 0 0 0 0 - - 0 0 0 0 0 0 - - 0 0 0 0 0 0 0 0 0 0 0 - 0 0 0 0 0 0 0 0 
0 0 0 1 2 0 0 0 - 0 0 0 0 0 0 0 0 0 0 0 - - 0 0 0 0 0 0 - - 0 0 0 0 0 0 0 0 0 0 0 - 0 0 0 7 8 0 0 0 
0 0 0 2 1 0 0 0 - 0 0 0 0 0 0 0 0 - - - 0 0 - 0 0 - - - 0 0 - 0 0 0 0 0 0 0 0 0 0 - 0 0 0 8 7 0 0 0 
0 0 0 0 0 0 0 0 - 0 0 0 0 0 0 0 - 0 0 0 0 0 - 0 - 0 0 0 0 0 - 0 0 0 0 0 0 0 0 0 0 - 0 0 0 0 0 0 0 0 
0 0 0 0 0 0 0 0 - 0 0 0 0 0 0 0 - 0 0 i 0 0 - 0 - 0 0 i 0 0 - 0 0 0 0 0 0 0 0 0 0 - 0 0 0 0 0 0 0 0 
0 0 0 0 0 0 0 0 - 0 0 0 0 0 0 0 - 0 0 0 0 0 - 0 - 0 0 0 0 0 - 0 0 0 0 0 0 0 0 0 0 - 0 0 0 0 0 0 0 0 
7 7 3 <-> 9 9 7
40 28 3 <-> 42 30 7
7 34 2 <-> 9 34 6
40 34 2 <-> 42 34 6
7 33 3 <-> 9 35 7
7 35 1 <-> 9 33 5
40 33 3 <-> 42 35 7
42 33 5 <-> 40 35 1
7 3 2 <-> 9 3 6
7 2 3 <-> 9 4 7
7 4 1 <-> 9 2 5
40 3 2 <-> 42 3 6
7 30 1 <-> 9 28 5
42 7 5 <-> 40 9 1
40 2 3 <-> 42 4 7
42 2 5 <-> 40 4 1
12 30 0 <-> 12 28 4
15 30 7 <-> 13 28 3
17 30 0 <-> 14 4 2
32 30 0 <-> 35 4 6
37 30 0 <-> 37 28 4
34 30 1 <-> 36 28 5
16 12 2 <-> 18 12 6
16 11 3 <-> 18 13 7
16 13 1 <-> 18 11 5
31 11 3 <-> 33 13 7
31 12 2 <-> 33 12 6
31 13 1 <-> 33 11 5
16 24 3 <-> 18 26 7
16 25 2 <-> 18 25 6
18 24 5 <-> 16 26 1
31 24 3 <-> 33 26 7
31 25 2 <-> 33 25 6
33 24 5 <-> 31 26 1
