8
0
0 0
20 20
- - - - 2 2 0 0 0 0 0 0 0 0 3 3 - - - -
- - - 2 0 0 0 0 0 0 0 0 0 0 0 0 3 - - -
- - 0 0 0 0 0 0 0 0 0 0 0 0 0 0 0 0 - -
- 1 0 0 0 0 0 0 0 0 0 0 0 0 0 0 0 0 4 -
1 0 0 0 0 0 0 0 0 0 0 0 0 0 0 0 0 0 0 4
1 0 0 0 0 0 1 2 3 4 5 6 7 8 0 0 0 0 0 4
0 0 0 0 0 0 2 3 4 5 6 7 8 1 0 0 0 0 0 0 
0 0 0 0 0 0 3 4 5 6 7 8 1 2 0 0 0 0 0 0 
0 0 0 0 0 0 4 5 6 7 8 1 2 3 0 0 0 0 0 0
0 0 0 0 0 0 5 6 7 8 1 2 3 4 0 0 0 0 0 0
0 0 0 0 0 0 6 7 8 1 2 3 4 5 0 0 0 0 0 0
0 0 0 0 0 0 7 8 1 2 3 4 5 6 0 0 0 0 0 0
0 0 0 0 0 0 8 1 2 3 4 5 6 7 0 0 0 0 0 0
0 0 0 0 0 0 0 0 0 0 0 0 0 0 0 0 0 0 0 0
8 0 0 0 0 0 0 0 0 0 0 0 0 0 0 0 0 0 0 5
8 0 0 0 0 0 0 0 0 0 0 0 0 0 0 0 0 0 0 5
- 8 0 0 0 0 0 0 0 0 0 0 0 0 0 0 0 0 5 -
- - 0 0 0 0 0 0 0 0 0 0 0 0 0 0 0 0 - -
- - - 7 0 0 0 0 0 0 0 0 0 0 0 0 6 - - -
- - - - 7 7 0 0 0 0 0 0 0 0 6 6 - - - -
