2
4
5 1
18 19
b 0 0 0 0 0 0 0 1 2 0 0 0 0 0 0 0 b - 
0 0 0 0 0 0 0 0 2 1 0 0 0 0 0 0 0 0 - 
0 0 0 0 0 0 0 0 1 2 0 0 0 0 0 0 0 0 0 
0 0 0 0 0 0 0 0 2 1 0 0 0 0 0 0 0 0 - 
0 0 0 0 0 0 0 0 1 2 0 0 0 0 0 0 0 0 0 
0 0 0 0 0 0 0 0 2 1 0 0 0 0 0 0 0 0 - 
0 0 0 0 0 0 0 0 1 2 0 0 0 0 0 0 0 0 0 
0 0 0 0 0 0 0 0 2 1 0 0 0 0 0 0 0 0 - 
0 0 0 0 0 0 0 0 1 2 0 0 0 0 0 0 0 0 c 
0 0 0 0 0 0 0 0 2 1 0 0 0 0 0 0 0 0 c 
0 0 0 0 0 0 0 0 1 2 0 0 0 0 0 0 0 0 - 
0 0 0 0 0 0 0 0 2 1 0 0 0 0 0 0 0 0 0 
0 0 0 0 0 0 0 0 1 2 0 0 0 0 0 0 0 0 - 
0 0 0 0 0 0 0 0 2 1 0 0 0 0 0 0 0 0 0 
0 0 0 0 0 0 0 0 1 2 0 0 0 0 0 0 0 0 - 
0 0 0 0 0 0 0 0 2 1 0 0 0 0 0 0 0 0 0 
0 0 0 0 0 0 0 0 1 2 0 0 0 0 0 0 0 0 - 
b 0 0 0 0 0 0 0 2 1 0 0 0 0 0 0 0 b - 
16 17 4 <-> 15 0 0
15 17 4 <-> 14 0 0
14 17 4 <-> 13 0 0
13 17 4 <-> 12 0 0
12 17 4 <-> 11 0 0
11 17 4 <-> 10 0 0
10 17 4 <-> 9 0 0
9 17 4 <-> 8 0 0
8 17 4 <-> 7 0 0
7 17 4 <-> 6 0 0
6 17 4 <-> 5 0 0
5 17 4 <-> 4 0 0
4 17 4 <-> 3 0 0
3 17 4 <-> 2 0 0
2 17 4 <-> 1 0 0
