2
2
8 0
22 25
- - - 0 0 0 0 0 0 0 0 - - - - - - 0 0 0 0 0 0 0 0 
- - - 0 0 0 2 1 0 0 0 - - - - - - 0 0 0 0 0 0 0 0 
- - - 0 0 0 1 2 0 0 0 - - - - - - 0 - - 0 0 - - 0 
- - - 0 0 0 0 0 0 0 0 - - - - - - 0 - - 0 0 - - 0 
- - - 0 - - 0 0 - - 0 - - - - - - 0 0 0 - - 0 0 0 
- - - 0 0 0 0 0 0 0 0 - - - - - - 0 0 - - - - 0 0 
- - - 0 - - - - - - 0 - - - - - - 0 0 - - - - 0 0 
- - - 0 0 0 0 0 0 0 0 - - - - - - 0 0 - 0 0 - 0 0 
- - - - - - 0 0 - - - - - - - - - - 0 0 0 0 0 0 - 
- - - - - - 0 0 - - - - - - - - - - 0 0 0 0 0 0 - 
- 0 0 0 0 0 0 0 0 0 0 0 0 - - - - - 0 0 0 0 0 0 - 
- 0 - - 0 0 0 0 0 0 - - 0 - - - - - 0 0 0 0 0 0 - 
- 0 - c - 0 0 0 0 - c - 0 - - - - - 0 0 1 2 0 0 - 
- 0 - - 0 0 0 0 0 0 - - 0 - - - - - 0 0 2 1 0 0 - 
- 0 - c - 0 0 0 0 - c - 0 - - - - - 0 0 0 0 0 0 - 
- 0 - - 0 0 0 0 0 0 - - 0 - - - - - 0 0 0 0 0 0 - 
- - - - 0 0 - - 0 0 - - - - - - - - 0 0 0 0 0 0 - 
- - - 0 0 0 0 0 0 0 0 - - - - - - - 0 0 0 0 0 0 - 
- - - - 0 0 - - 0 0 - - - - - - - - 0 0 0 0 0 0 - 
- - - - 0 0 - - 0 0 - - - - - - - 0 0 0 0 0 0 0 0 
- - - - 0 0 - - 0 0 - - - - - - - 0 0 0 0 0 0 0 0 
- - - - 0 0 - - 0 0 - - - - - - - 0 0 0 0 0 0 0 0 
12 15 3 <-> 17 19 7
5 21 3 <-> 17 21 5
9 21 2 <-> 24 21 2
7 8 2 <-> 18 8 6
1 15 5 <-> 24 19 1
7 17 4 <-> 21 0 0
6 17 4 <-> 20 0 0
9 13 2 <-> 12 13 6
12 13 2 <-> 18 13 6
4 13 6 <-> 1 13 2
1 13 6 <-> 23 13 2
10 4 2 <-> 17 4 6
3 4 6 <-> 24 4 2
7 4 2 <-> 22 4 6
6 4 6 <-> 19 4 2
6 8 6 <-> 23 8 2
3 17 6 <-> 22 1 4
10 17 2 <-> 18 1 4
7 15 4 <-> 21 3 4
6 15 4 <-> 20 3 4
