2
0
2 2
10 16
- - - - 1 1 0 0 0 0 2 2 - - - - 
- - - 1 1 0 0 0 0 0 0 2 2 - - - 
- - 1 1 0 0 0 0 0 0 0 0 2 2 - - 
- 1 1 0 0 0 0 0 0 0 0 0 0 2 2 - 
1 1 0 0 0 0 1 b b 2 0 0 0 0 2 2 
1 1 0 0 0 0 1 b b 2 0 0 0 0 2 2 
- 1 1 0 0 0 0 0 0 0 0 0 0 2 2 - 
- - 1 1 0 0 0 0 0 0 0 0 2 2 - - 
- - - 1 1 0 0 0 0 0 0 2 2 - - - 
- - - - 1 1 0 0 0 0 2 2 - - - - 