2
2
2 0
15 15
0 0 0 0 - 0 0 0 0 0 0 0 0 0 0 
0 0 0 0 0 0 - 0 0 0 0 0 0 0 0 
0 0 0 0 0 0 x 0 0 0 0 0 0 - - 
0 0 0 - 0 x x x 0 0 0 0 0 0 0 
0 0 0 0 0 0 x 0 0 0 0 - 0 0 0 
0 0 0 0 - 0 0 - 0 0 0 0 0 - 0 
0 0 0 0 0 0 0 0 - i 0 - - - 0 
0 0 0 0 0 0 0 0 - - 0 0 0 0 0 
0 0 0 0 0 0 0 0 0 0 0 1 2 0 0 
0 0 0 0 0 0 0 - 0 0 0 2 1 0 0 
0 0 - 0 0 0 0 0 0 0 0 0 0 0 0 
0 0 0 0 0 - 0 - 0 0 0 0 0 - 0 
0 0 b 0 - 0 0 0 0 0 0 0 0 0 0 
0 0 0 0 b 0 0 0 0 0 0 0 0 0 0 
0 0 0 0 0 i 0 0 0 0 - 0 0 0 - 
0 3 5 <-> 6 0 4
8 8 5 <-> 9 14 3
12 5 5 <-> 6 10 5
14 10 3 <-> 13 7 7
7 8 4 <-> 7 0 7
3 13 1 <-> 14 5 6
10 4 2 <-> 6 0 7
7 14 3 <-> 14 9 2
4 14 4 <-> 12 7 7
3 5 2 <-> 5 0 6
14 7 3 <-> 13 14 3
7 1 6 <-> 14 11 3
2 11 0 <-> 8 8 0
7 0 5 <-> 9 6 5
0 4 5 <-> 14 12 2
