2
1
1 1
11 11
c 0 0 - 0 2 1 - 0 0 b 
0 0 0 - 0 1 2 - 0 0 0 
0 0 0 - 0 0 0 - 0 0 0 
- - - - - - - - - - - 
0 0 0 - - 0 - - 0 2 1 
2 1 0 - 0 x 0 - 0 1 2 
1 2 0 - - 0 - - 0 0 0 
- - - - - - - - - - - 
0 0 0 - 0 0 0 - 0 0 0 
0 0 0 - 2 1 0 - 0 0 0 
b 0 0 - 1 2 0 - 0 0 c 
6 5 2 <-> 8 5 6
5 2 4 <-> 5 4 0
2 5 2 <-> 4 5 6
5 6 4 <-> 5 8 0
2 8 1 <-> 5 5 5
5 5 1 <-> 8 2 5
2 2 3 <-> 5 5 7
5 5 3 <-> 8 8 7
