2
0
1 2
15 25
0 0 0 0 0 0 0 - - - - - - - - - - - 0 0 0 0 0 0 0 
0 b 0 0 0 - 0 0 0 - - - - - - - - - 0 - i 0 0 b 0 
0 0 0 0 0 - 0 0 0 - - - - - - - - - 0 - 0 0 0 0 0 
0 0 0 0 0 0 0 0 0 0 0 0 0 - - - - - 0 0 0 0 0 0 0 
0 - - 0 0 0 0 0 0 0 0 0 0 0 0 - 0 0 0 0 0 0 - - 0 
0 0 0 0 0 0 0 0 0 0 0 0 0 0 0 - 0 0 0 0 0 0 0 0 0 
- - - - - - 0 0 0 0 0 2 1 0 0 0 0 0 0 0 0 - - - - 
- - - - 0 0 0 0 0 0 0 1 2 0 0 0 0 0 0 0 0 - - - - 
- - - - 0 0 0 0 0 0 0 0 0 0 0 0 0 0 0 - - - - - - 
0 0 0 0 0 0 0 0 0 - 0 0 0 0 0 0 0 0 0 0 0 0 0 0 0 
0 - - 0 0 0 0 0 0 - 0 0 0 0 0 0 0 0 0 0 0 0 - - 0 
0 0 0 0 0 0 0 - - - - - 0 0 0 0 0 0 0 0 0 0 0 0 0 
0 0 0 0 0 - 0 - - - - - - - - - 0 0 0 - 0 0 0 0 0 
0 b 0 0 i - 0 - - - - - - - - - 0 0 0 - 0 0 0 b 0 
0 0 0 0 0 0 0 - - - - - - - - - - - 0 0 0 0 0 0 0 
24 14 3 <-> 24 0 1
0 14 5 <-> 0 0 7
15 6 0 <-> 9 8 4
6 6 6 <-> 18 8 2
6 14 3 <-> 6 0 1
18 0 7 <-> 18 14 5
0 9 7 <-> 24 9 1
0 5 5 <-> 24 5 3
