2
2
2 1
38 35
x b 0 0 0 0 0 0 0 0 0 0 0 0 0 0 0 0 0 0 0 0 0 0 0 0 0 0 0 0 0 0 0 b x 
b b 0 0 0 0 0 0 0 0 0 0 0 0 0 0 0 0 0 0 0 0 0 0 0 0 0 0 0 0 0 0 0 b b 
0 0 0 0 0 0 0 0 0 0 0 0 0 0 0 0 0 0 0 0 0 0 0 0 0 0 0 0 0 0 0 0 0 0 0 
0 0 0 0 0 0 0 0 0 0 0 0 0 0 0 0 0 0 0 0 0 0 0 0 0 0 0 0 0 0 0 0 0 0 0 
0 0 0 0 - - - - - - - 0 0 0 0 - - - - - 0 0 0 0 - - - - - - - 0 0 0 0 
0 0 0 0 - - - - - - - 0 0 0 0 - - - - - 0 0 0 0 - - - - - - - 0 0 0 0 
0 0 0 0 - - - - - - - 0 0 0 0 - - - - - 0 0 0 0 - - - - - - - 0 0 0 0 
0 0 0 0 - - - - - - - 0 0 0 0 - - - - - 0 0 0 0 - - - - - - - 0 0 0 0 
0 0 0 0 - - - - - - - b b b b - - - - - b b b b - - - - - - - 0 0 0 0 
0 0 0 0 - - - - - - - i i i i - - - - - i i i i - - - - - - - 0 0 0 0 
0 0 0 0 - - - - - - - 0 0 0 0 - - - - - 0 0 0 0 - - - - - - - 0 0 0 0 
0 0 0 0 - - - - - - - 0 0 0 0 - - - - - 0 0 0 0 - - - - - - - 0 0 0 0 
0 0 0 0 - - - - - - - 0 0 0 0 - - - - - 0 0 0 0 - - - - - - - 0 0 0 0 
0 0 0 0 - - - - - - - 0 0 0 0 - - - - - 0 0 0 0 - - - - - - - 0 0 0 0 
0 0 0 0 - - - - - - - 0 0 0 0 - - - - - 0 0 0 0 - - - - - - - 0 0 0 0 
0 0 0 0 - - - - - - - 0 0 0 0 - - - - - 0 0 0 0 - - - - - - - 0 0 0 0 
0 0 0 0 - - - - - - 0 0 0 0 0 0 0 0 0 0 0 0 0 0 0 - - - - - - 0 0 0 0 
0 0 0 0 0 b i 0 0 0 0 0 0 0 0 0 0 0 0 0 0 0 0 0 0 0 0 0 i b 0 0 0 0 0 
0 0 0 0 0 b i 0 0 0 0 0 0 0 0 0 0 1 2 0 0 0 0 0 0 0 0 0 i b 0 0 0 0 0 
0 0 0 0 0 b i 0 0 0 0 0 0 0 0 0 0 2 1 0 0 0 0 0 0 0 0 0 i b 0 0 0 0 0 
0 0 0 0 0 b i 0 0 0 0 0 0 0 0 0 0 0 0 0 0 0 0 0 0 0 0 0 i b 0 0 0 0 0 
0 0 0 0 - - - - - - 0 0 0 0 0 0 0 0 0 0 0 0 0 0 0 - - - - - - 0 0 0 0 
0 0 0 0 - - - - - - - 0 0 0 0 - - - - - 0 0 0 0 - - - - - - - 0 0 0 0 
0 0 0 0 - - - - - - - 0 0 0 0 - - - - - 0 0 0 0 - - - - - - - 0 0 0 0 
0 0 0 0 - - - - - - - 0 0 0 0 - - - - - 0 0 0 0 - - - - - - - 0 0 0 0 
0 0 0 0 - - - - - - - 0 0 0 0 - - - - - 0 0 0 0 - - - - - - - 0 0 0 0 
0 0 0 0 - - - - - - - 0 0 0 0 - - - - - 0 0 0 0 - - - - - - - 0 0 0 0 
0 0 0 0 - - - - - - - 0 0 0 0 - - - - - 0 0 0 0 - - - - - - - 0 0 0 0 
0 0 0 0 - - - - - - - i i i i - - - - - i i i i - - - - - - - 0 0 0 0 
0 0 0 0 - - - - - - - b b b b - - - - - b b b b - - - - - - - 0 0 0 0 
0 0 0 0 - - - - - - - 0 0 0 0 - - - - - 0 0 0 0 - - - - - - - 0 0 0 0 
0 0 0 0 - - - - - - - 0 0 0 0 - - - - - 0 0 0 0 - - - - - - - 0 0 0 0 
0 0 0 0 - - - - - - - 0 0 0 0 - - - - - 0 0 0 0 - - - - - - - 0 0 0 0 
0 0 0 0 - - - - - - - 0 0 0 0 - - - - - 0 0 0 0 - - - - - - - 0 0 0 0 
0 0 0 0 0 0 0 0 0 0 0 0 0 0 0 0 0 0 0 0 0 0 0 0 0 0 0 0 0 0 0 0 0 0 0 
0 0 0 0 0 0 0 0 0 0 0 0 0 0 0 0 0 0 0 0 0 0 0 0 0 0 0 0 0 0 0 0 0 0 0 
b b 0 0 0 0 0 0 0 0 0 0 0 0 0 0 0 0 0 0 0 0 0 0 0 0 0 0 0 0 0 0 0 b b 
x b 0 0 0 0 0 0 0 0 0 0 0 0 0 0 0 0 0 0 0 0 0 0 0 0 0 0 0 0 0 0 0 b x 
