2
2
1 2
12 12
x x 0 0 - c b - 0 0 0 0
0 0 0 0 - 0 0 - i 0 0 0
- - - - - 0 0 - - - - -
0 0 - 0 0 0 0 0 0 - 0 0
0 0 - 0 0 0 0 0 0 - 0 0
0 0 0 0 0 1 2 0 0 0 0 0
0 0 0 0 0 2 1 0 0 0 0 0
0 0 - 0 0 0 0 0 0 - 0 0
0 0 - 0 0 0 0 0 0 - 0 0
- - - - - 0 0 - - - - -
0 0 0 i - 0 0 - 0 0 0 0
0 0 0 0 - b c - 0 0 x x
0 0 6 <-> 0 5 6
0 11 5 <-> 0 6 6
11 0 1 <-> 11 5 2
11 11 3 <-> 11 6 2