2
6
2 2
31 31
c 0 0 0 0 0 0 0 0 0 0 0 0 0 0 0 0 0 0 0 0 0 0 0 0 0 0 0 0 0 - 
0 0 0 0 0 0 0 0 0 0 0 0 0 0 0 0 0 0 0 0 0 0 0 0 0 0 0 0 0 0 0 
0 0 b - 0 0 0 0 0 0 b 0 0 0 2 1 2 0 0 0 b 0 0 0 0 0 0 0 0 0 0 
0 0 - - - i 0 0 0 0 0 0 0 0 1 2 1 0 0 0 0 0 0 0 0 0 0 0 0 0 0 
0 0 0 - - - i 0 0 0 0 0 0 0 2 1 2 0 0 0 0 x - - - 0 0 0 0 0 0 
0 0 0 0 - - - 0 0 0 0 0 0 0 0 0 0 0 x 0 - - - - - - 0 0 0 0 0 
0 0 0 0 0 - - - 0 0 0 0 0 0 0 0 0 0 0 - - - - - - - - 0 0 0 0 
0 0 0 0 0 0 - - - - 0 0 0 0 0 0 0 0 0 0 - - - - - - - 0 0 0 0 
0 0 0 0 0 0 0 - - - - 0 0 0 0 b 0 0 0 0 0 - - - - - - 0 0 0 0 
0 0 0 0 0 0 0 - - - - - 0 0 0 0 0 0 0 0 0 0 - - - - - 0 0 0 0 
0 0 0 0 0 0 0 0 - - - - - 0 0 0 0 0 0 0 0 0 0 - - - - b 0 0 0 
0 0 0 0 0 0 0 0 0 - - - - - 0 0 0 0 0 0 0 0 0 0 - - - 0 0 0 0 
0 0 0 0 0 0 0 0 0 0 - - - - - 0 0 0 0 0 0 0 0 0 0 - 0 0 0 0 0 
0 0 0 0 0 0 0 0 0 0 0 - - - - - - 0 0 0 0 0 0 0 0 0 b 0 0 0 0 
0 0 0 0 0 0 0 0 0 0 0 0 - - - - - - c 0 0 0 0 0 0 0 0 0 0 0 0 
0 0 0 0 0 0 0 0 0 0 0 0 0 - - - - - - 0 0 0 0 0 0 0 0 0 0 0 0 
0 0 0 0 0 0 0 0 0 0 0 0 0 - - - - - - - 0 0 0 0 0 0 0 0 0 0 0 
0 0 0 0 b 0 0 0 0 0 0 0 0 0 - - - - - - - 0 0 0 0 0 0 0 0 0 0 
0 0 0 0 0 - 0 0 0 0 0 0 0 0 c - - - - - - - 0 0 0 0 0 0 0 0 0 
0 0 0 0 - - - 0 0 0 0 0 0 0 0 0 - - - - - - - 0 0 0 0 0 0 0 0 
0 0 0 b - - - - 0 0 0 0 0 0 0 0 0 - - - - - - - 0 0 0 0 0 0 0 
0 0 0 - - - - - - 0 0 0 0 0 0 0 0 0 - - - - - - - - 0 0 0 0 0 
0 0 0 - - - - - - - 0 0 0 0 0 b 0 0 0 - - - - - - - - 0 0 0 0 
0 0 0 - - - - - - - - 0 0 0 0 0 0 0 0 0 - - - - - - - - 0 0 0 
0 0 0 0 - - - - - - - - 0 0 0 0 0 0 0 0 0 - - - - - - - - 0 0 
0 0 0 0 0 - - - - - - 0 x 0 0 0 0 0 0 0 0 - - - - - - - - 0 0 
0 0 0 0 0 0 0 0 0 x 0 0 0 0 1 2 1 0 0 0 0 i - - - - - - - 0 0 
0 0 0 0 0 0 0 0 0 0 0 0 0 0 2 1 2 0 0 0 0 0 i - - - - - - 0 0 
0 0 0 0 0 0 0 0 0 0 b 0 0 0 1 2 1 0 0 0 b 0 0 0 - - - - b 0 0 
0 0 0 0 0 0 0 0 0 0 0 0 0 0 0 0 0 0 0 0 0 0 0 0 0 0 0 0 0 0 0 
- 0 0 0 0 0 0 0 0 0 0 0 0 0 0 0 0 0 0 0 0 0 0 0 0 0 0 0 0 0 c 
4 25 1 <-> 9 20 5
3 24 1 <-> 8 19 5
3 20 3 <-> 9 26 7
4 17 3 <-> 12 25 7
5 17 4 <-> 5 26 0
20 24 1 <-> 24 20 5
12 15 1 <-> 15 12 5
6 8 1 <-> 8 6 5
16 20 1 <-> 20 16 5
23 28 1 <-> 28 23 5
9 12 1 <-> 12 9 5
25 4 5 <-> 20 9 1
26 5 5 <-> 21 10 1
27 10 7 <-> 21 4 3
26 13 7 <-> 18 5 3
27 6 6 <-> 18 6 2
