2
1
0 1
19 19
0 0 0 0 0 0 0 - - - - - 0 0 0 0 0 0 0 
0 0 0 0 0 0 0 - - - - - 0 0 0 0 0 0 0 
0 0 1 2 0 0 0 - - - - - 0 0 0 1 2 0 0 
0 0 2 1 0 0 0 - - - - - 0 0 0 2 1 0 0 
0 0 0 0 0 0 0 - - - - - 0 0 0 0 0 0 0 
0 0 0 0 0 0 b 0 - - - 0 b 0 0 0 0 0 0 
0 0 0 0 0 b 0 0 0 - 0 0 0 b 0 0 0 0 0 
- - - - - 0 0 0 0 0 0 0 0 0 - - - - - 
- - - - - - 0 0 0 0 0 0 0 - - - - - - 
- - - - - - - 0 0 b 0 0 - - - - - - - 
- - - - - - 0 0 0 0 0 0 0 - - - - - - 
- - - - - 0 0 0 0 0 0 0 0 0 - - - - - 
0 0 0 0 0 b 0 0 0 - 0 0 0 b 0 0 0 0 0 
0 0 0 0 0 0 b 0 - - - 0 b 0 0 0 0 0 0 
0 0 0 0 0 0 0 - - - - - 0 0 0 0 0 0 0 
0 0 1 2 0 0 0 - - - - - 0 0 0 1 2 0 0 
0 0 2 1 0 0 0 - - - - - 0 0 0 2 1 0 0 
0 0 0 0 0 0 0 - - - - - 0 0 0 0 0 0 0 
0 0 0 0 0 0 0 - - - - - 0 0 0 0 0 0 0 
9 7 0 <-> 9 11 4
7 9 6 <-> 11 9 2
