2
2
0 0
16 20
0 x 0 - - - - - 0 0 0 0 - - - - - 0 x 0
- 0 0 0 - - - - 0 0 0 0 - - - - 0 0 0 -
- - 0 0 0 - - - 0 0 0 0 - - - 0 0 0 - -
- - - 0 b 0 - - 0 0 0 0 - - 0 b 0 - - -
- - - - 0 0 0 - 0 0 0 0 - 0 0 0 - - - -
- - - - - 0 0 b 0 0 0 0 b 0 0 - - - - -
- 0 0 0 0 0 0 0 0 x x 0 0 0 0 0 0 0 0 -
- 0 1 1 2 0 0 0 0 x x 0 0 0 0 1 2 2 0 -
- 0 1 2 1 0 0 0 0 x x 0 0 0 0 2 1 2 0 -
- 0 0 0 0 0 0 0 0 x x 0 0 0 0 0 0 0 0 -
- - - - - 0 0 b 0 0 0 0 b 0 0 - - - - -
- - - - 0 0 0 - 0 0 0 0 - 0 0 0 - - - -
- - - 0 b 0 - - 0 0 0 0 - - 0 b 0 - - -
- - 0 0 0 - - - 0 0 0 0 - - - 0 0 0 - -
- 0 0 0 - - - - 0 0 0 0 - - - - 0 0 0 -
0 x 0 - - - - - 0 0 0 0 - - - - - 0 x 0
0 0 0 <-> 19 15 4
1 0 0 <-> 18 15 4
2 0 0 <-> 17 15 4
17 0 0 <-> 0 15 4
18 0 0 <-> 1 15 4
19 0 0 <-> 2 15 4
1 6 6 <-> 18 6 2
1 7 6 <-> 18 7 2
1 8 6 <-> 18 8 2
1 9 6 <-> 18 9 2