2
5
1 3
15 15
- - - - - i i i i i - - - - -
- - - - i i 0 c 0 i i - - - -
- - - - i 0 0 i 0 0 i - - - -
- - - - i 0 0 i 0 0 i - - - -
- i i i i i 0 i 0 i i i i i -
i i 0 0 i i 0 0 0 i i 0 0 i i
i 0 0 0 0 0 1 2 1 0 0 0 0 0 i
i c i i i 0 x x x 0 i i i c i
i 0 0 0 0 0 2 1 2 0 0 0 0 0 i
i i 0 0 i i 0 0 0 i i 0 0 i i
- i i i i i 0 i 0 i i i i i -
- - - - i 0 0 i 0 0 i - - - -
- - - - i 0 0 i 0 0 i - - - -
- - - - i i 0 c 0 i i - - - -
- - - - - i i i i i - - - - -
7 0 0 <-> 7 14 4
0 7 6 <-> 14 7 2