2
0
0 4
15 23
- - - - - - - - - - - - - - - - - - - - - - - 
- - - - - - - - - - - - - - - - - - - - - - - 
- - - - - - - - - - - - - - - - - - - - - - - 
- - 0 0 0 0 0 0 0 0 0 0 0 0 0 0 0 0 0 0 - - - 
- - 0 0 0 0 0 0 0 0 0 0 0 0 0 0 0 0 0 0 - - c 
- - 0 0 0 0 0 0 0 0 0 0 0 0 0 0 0 0 0 0 - - - 
- - 0 0 0 0 0 0 0 0 0 0 0 0 0 0 0 0 0 0 - - - 
- - 0 0 0 0 0 0 0 0 0 0 0 0 0 0 0 0 0 0 - - i 
- - 0 0 0 0 0 0 0 0 1 2 0 0 0 0 0 0 0 0 - - - 
- - 0 0 0 0 0 0 0 0 2 1 0 0 0 0 0 0 0 0 - - - 
- - 0 0 0 0 0 0 0 0 0 0 0 0 0 0 0 0 0 0 - - b 
- - 0 0 0 0 0 0 0 0 0 0 0 0 0 0 0 0 0 0 - - - 
- - 0 0 0 0 0 0 0 0 0 0 0 0 0 0 0 0 0 0 - - - 
- - 0 0 0 0 0 0 0 0 0 0 0 0 0 0 0 0 0 0 - - x 
- - 0 0 0 0 0 0 0 0 0 0 0 0 0 0 0 0 0 0 - - - 
