2
10
2 4
40 40
1 0 0 0 0 0 0 0 0 0 0 0 0 0 0 0 0 0 0 0 0 0 0 0 0 0 0 0 0 0 0 0 0 0 0 0 0 0 0 2 
0 0 0 0 0 0 0 0 0 0 0 0 0 0 0 0 0 0 0 0 0 0 0 0 0 0 0 0 0 0 0 0 0 0 0 0 0 0 0 0 
0 0 0 0 0 0 0 0 0 0 0 0 0 0 0 0 0 0 0 0 0 0 0 0 0 0 0 0 0 0 0 0 0 0 0 0 0 0 0 0 
0 0 0 0 0 0 0 0 0 0 0 x x x x x x x x x x x x x x x x x x 0 0 0 0 0 0 0 0 0 0 0 
0 0 0 0 0 0 0 0 x x x x x x x x x x x x x x x x x x x x x x x x 0 0 0 0 0 0 0 0 
0 0 0 0 0 x x x x x x x x x x x x x x x x x x x x x x x x x x x x x x 0 0 0 0 0 
0 0 0 0 0 x x x x x x x x x x x x x x x x x x x x x x x x x x x x x x 0 0 0 0 0 
0 0 0 0 0 x x x x x x x x x x x x x x x x x x x x x x x x x x x x x x 0 0 0 0 0 
0 0 0 0 x x x x x x x x x x x x x x x x x x x x x x x x x x x x x x x x 0 0 0 0 
0 0 0 0 x x x x x x x x 0 0 0 0 0 0 0 0 0 0 0 0 0 0 0 0 x x x x x x x x 0 0 0 0 
0 0 0 0 x x x x x x x 0 0 0 0 0 0 0 0 0 0 0 0 0 0 0 0 0 0 x x x x x x x 0 0 0 0 
0 0 0 x x x x x x x 0 0 0 0 0 0 0 0 0 0 0 0 0 0 0 0 0 0 0 0 x x x x x x x 0 0 0 
0 0 0 x x x x x x 0 0 0 0 0 0 0 0 0 0 0 0 0 0 0 0 0 0 0 0 0 0 x x x x x x 0 0 0 
0 0 0 x x x x x x 0 0 0 0 0 0 0 0 0 0 0 0 0 0 0 0 0 0 0 0 0 0 x x x x x x 0 0 0 
0 0 0 x x x x x x 0 0 0 0 0 0 0 0 0 0 0 0 0 0 0 0 0 0 0 0 0 0 x x x x x x 0 0 0 
0 0 0 x x x x x x 0 0 0 0 0 0 0 0 0 0 0 0 0 0 0 0 0 0 0 0 0 0 x x x x x x 0 0 0 
0 0 0 x x x x x x 0 0 0 0 0 0 0 0 0 0 0 0 0 0 0 0 0 0 0 0 0 0 x x x x x x 0 0 0 
0 0 0 x x x x x x 0 0 0 0 0 0 0 0 0 0 0 0 0 0 0 0 0 0 0 0 0 0 x x x x x x 0 0 0 
0 0 0 x x x x x x 0 0 0 0 0 0 0 0 0 0 0 0 0 0 0 0 0 0 0 0 0 0 x x x x x x 0 0 0 
0 0 0 x x x x x x 0 0 0 0 0 0 0 0 0 0 1 2 0 0 0 0 0 0 0 0 0 0 x x x x x x 0 0 0 
0 0 0 x x x x x x 0 0 0 0 0 0 0 0 0 0 2 1 0 0 0 0 0 0 0 0 0 0 x x x x x x 0 0 0 
0 0 0 x x x x x x 0 0 0 0 0 0 0 0 0 0 0 0 0 0 0 0 0 0 0 0 0 0 x x x x x x 0 0 0 
0 0 0 x x x x x x 0 0 0 0 0 0 0 0 0 0 0 0 0 0 0 0 0 0 0 0 0 0 x x x x x x 0 0 0 
0 0 0 x x x x x x 0 0 0 0 0 0 0 0 0 0 0 0 0 0 0 0 0 0 0 0 0 0 x x x x x x 0 0 0 
0 0 0 x x x x x x 0 0 0 0 0 0 0 0 0 0 0 0 0 0 0 0 0 0 0 0 0 0 x x x x x x 0 0 0 
0 0 0 x x x x x x 0 0 0 0 0 0 0 0 0 0 0 0 0 0 0 0 0 0 0 0 0 0 x x x x x x 0 0 0 
0 0 0 x x x x x x 0 0 0 0 0 0 0 0 0 0 0 0 0 0 0 0 0 0 0 0 0 0 x x x x x x 0 0 0 
0 0 0 x x x x x x 0 0 0 0 0 0 0 0 0 0 0 0 0 0 0 0 0 0 0 0 0 0 x x x x x x 0 0 0 
0 0 0 x x x x x x x 0 0 0 0 0 0 0 0 0 0 0 0 0 0 0 0 0 0 0 0 x x x x x x x 0 0 0 
0 0 0 0 x x x x x x x 0 0 0 0 0 0 0 0 0 0 0 0 0 0 0 0 0 0 x x x x x x x 0 0 0 0 
0 0 0 0 x x x x x x x x 0 0 0 0 0 0 0 0 0 0 0 0 0 0 0 0 x x x x x x x x 0 0 0 0 
0 0 0 0 x x x x x x x x x x x x x x x x x x x x x x x x x x x x x x x x 0 0 0 0 
0 0 0 0 0 x x x x x x x x x x x x x x x x x x x x x x x x x x x x x x 0 0 0 0 0 
0 0 0 0 0 x x x x x x x x x x x x x x x x x x x x x x x x x x x x x x 0 0 0 0 0 
0 0 0 0 0 x x x x x x x x x x x x x x x x x x x x x x x x x x x x x x 0 0 0 0 0 
0 0 0 0 0 0 0 0 x x x x x x x x x x x x x x x x x x x x x x x x 0 0 0 0 0 0 0 0 
0 0 0 0 0 0 0 0 0 0 0 x x x x x x x x x x x x x x x x x x 0 0 0 0 0 0 0 0 0 0 0 
0 0 0 0 0 0 0 0 0 0 0 0 0 0 0 0 0 0 0 0 0 0 0 0 0 0 0 0 0 0 0 0 0 0 0 0 0 0 0 0 
0 0 0 0 0 0 0 0 0 0 0 0 0 0 0 0 0 0 0 0 0 0 0 0 0 0 0 0 0 0 0 0 0 0 0 0 0 0 0 0 
2 0 0 0 0 0 0 0 0 0 0 0 0 0 0 0 0 0 0 0 0 0 0 0 0 0 0 0 0 0 0 0 0 0 0 0 0 0 0 1 
