2
3
0 3
15 16
- - - - - - - - - - - - - - - - 
- - 0 0 0 0 0 0 0 0 0 0 0 b - - 
- - 0 0 0 0 0 0 0 0 0 0 0 0 - - 
0 0 0 0 0 0 0 0 0 0 0 0 0 0 0 0 
0 0 1 2 0 0 0 0 0 0 0 0 0 0 0 0 
0 0 2 1 0 0 0 0 - - 0 - 0 0 0 0 
0 0 0 0 0 0 0 0 0 0 0 0 0 0 0 0 
0 0 0 0 0 0 0 - 0 - - 0 0 0 0 0 
0 0 0 0 0 - - i - - 0 0 0 0 0 0 
0 0 0 0 - - b - i - 0 0 0 0 0 0 
0 0 0 0 - 0 - - - - 0 0 2 1 0 0 
0 0 0 0 0 0 0 0 0 0 0 0 1 2 0 0 
0 0 0 0 0 0 0 0 0 0 0 0 0 0 0 0 
- - x 0 0 0 0 0 0 0 0 0 0 0 - - 
- - x x x 0 0 0 0 0 0 0 0 0 - - 
