2
0
1 2
43 35
- - - - - - - - - - - - - - - - - - - - - - - - - - - - - - - - - - - 
- - - - - - - - - - - - - - - - - - - - - - - - - - - - - - - - - - - 
- - - - - - - - - 0 0 0 0 0 0 0 0 0 0 0 0 0 0 0 - - - - - - - - - - - 
- - - - - - - 0 0 0 0 0 - 0 0 0 0 0 0 0 0 0 0 0 0 - - - - - - - - - - 
- - - - - 0 0 0 0 - - - - 0 0 0 0 0 0 0 0 0 0 0 0 0 0 0 0 0 - - - - - 
- - - - 0 0 0 0 - - 0 0 0 0 0 0 0 0 0 0 0 0 0 0 0 0 0 - - - 0 - - - - 
- - - 0 0 0 - - - 0 0 - - - - - 0 0 0 0 0 0 0 0 0 - - 0 0 0 - 0 - - - 
- - - 0 0 - - 0 0 - - 0 0 0 0 - - 0 0 0 0 0 0 0 - 0 0 0 0 - - - 0 - - 
- - 0 0 - - 0 0 - 0 0 0 0 0 0 0 - - 0 0 0 0 0 - 0 2 1 2 0 - - 0 - 0 - 
- - 0 0 0 0 0 0 - 0 0 0 0 0 0 0 0 - 0 0 0 0 0 - 0 1 2 1 0 0 0 0 - 0 - 
- - 0 0 0 0 0 0 - 0 - - c 0 0 0 0 - 0 0 0 0 0 - 0 2 1 2 0 0 0 0 - 0 - 
- 0 0 0 0 0 0 0 - 0 - - - 0 0 0 0 - 0 0 0 0 0 - 0 0 0 0 0 0 0 - - 0 - 
- 0 0 0 0 0 0 - - 0 - - c 0 0 0 0 - 0 0 0 0 0 0 - - 0 0 - - - - 0 - - 
- 0 0 0 0 0 0 0 - - 0 0 0 0 0 0 - - 0 0 0 0 0 0 0 - - - - - 0 0 - - - 
- 0 0 0 0 0 0 0 0 0 - - 0 0 - - - 0 0 0 0 0 0 0 0 0 - 0 0 0 0 0 - - - 
- 0 0 0 0 0 0 0 0 0 0 - - - - 0 0 0 0 0 0 0 0 0 0 - - 0 - - - 0 0 0 - 
- 0 0 0 0 0 0 0 0 0 0 0 0 0 0 0 0 0 0 - - - - - - - 0 - - - - - 0 0 - 
- 0 0 0 0 0 0 0 0 0 0 0 0 0 0 0 0 0 0 0 0 0 0 0 - 0 0 - 0 - 0 - - 0 0 
- 0 0 0 0 0 0 0 0 0 0 0 0 0 0 0 0 0 0 0 0 0 0 - - 0 - - - - - - - 0 0 
- 0 0 0 0 0 0 0 0 0 0 0 0 0 0 0 0 0 0 0 0 0 0 - - 0 - 0 0 0 0 0 - 0 0 
- 0 0 0 0 0 0 0 0 0 1 2 1 0 0 0 0 0 0 0 0 0 0 - 0 0 - 0 x x x 0 - 0 0 
- 0 0 0 0 0 0 0 0 0 2 1 2 0 0 0 0 0 0 0 0 0 0 - i 0 - 0 x 0 x 0 - 0 - 
- 0 0 0 0 0 0 0 0 0 1 2 1 0 0 0 0 0 0 0 0 0 0 0 - 0 - 0 x x x 0 - 0 - 
- 0 0 0 0 0 0 0 0 0 0 0 0 0 0 0 0 0 0 0 0 0 0 0 - 0 - 0 0 0 0 0 - 0 - 
- 0 0 0 0 0 0 0 0 0 0 0 0 0 0 0 0 0 0 0 0 0 0 0 - 0 - 0 0 0 0 - 0 0 - 
- - 0 0 0 0 0 0 0 0 0 0 0 0 0 0 0 0 0 0 0 0 0 0 - 0 - 0 0 0 0 - 0 - - 
- - 0 0 0 0 0 0 0 0 0 0 0 0 0 0 0 0 0 0 0 0 0 0 - 0 - 0 0 0 0 - 0 - - 
- - 0 0 0 0 0 0 0 0 0 0 0 0 0 0 0 0 0 0 0 0 0 0 - 0 - 0 0 0 0 - 0 - - 
- - - 0 0 0 0 0 0 0 0 0 b 0 0 0 0 0 0 0 0 0 0 - - - 0 0 0 0 0 - 0 0 - 
- - - 0 0 0 0 0 0 0 0 b 0 0 0 0 0 0 0 0 0 0 0 - 0 - - - - 0 0 - - 0 - 
- - - 0 0 0 0 0 0 0 b 0 0 0 0 0 0 0 0 0 0 0 0 - 0 - 0 0 0 - 0 0 - 0 - 
- - - - 0 0 0 0 0 0 0 0 0 0 0 0 0 0 0 0 0 0 - - 0 - 0 0 0 0 - 0 - 0 - 
- - - - 0 0 0 0 0 0 0 0 0 0 0 - - - 0 0 0 0 - 0 0 - 0 0 0 0 0 - - 0 - 
- - - - - 0 0 0 0 0 0 0 0 0 0 0 0 0 - - 0 0 - 0 0 - - - - - - - - 0 - 
- - - - - 0 0 0 0 0 0 0 0 0 0 0 0 0 0 0 - 0 - 0 0 - 0 - 0 - 0 - 0 0 - 
- - - - - - 0 0 0 0 0 0 0 0 0 0 0 0 0 0 0 - - 0 0 - - - - - - - 0 0 - 
- - - - - - - 0 0 0 0 0 0 0 0 0 0 0 0 0 0 0 - - 0 - - 0 0 0 - 0 0 0 - 
- - - - - - - 0 0 0 0 0 0 0 0 0 0 0 0 0 0 0 - - 0 0 - - - - - 0 0 - - 
- - - - - - - - - 0 0 0 0 0 0 0 0 0 0 0 0 0 0 - 0 0 0 0 0 0 0 0 0 - - 
- - - - - - - - - - - 0 0 0 0 0 0 0 0 0 0 0 0 - - - 0 0 0 0 0 0 - - - 
- - - - - - - - - - - - - 0 0 0 0 0 0 0 0 0 0 0 0 0 - - - - - - - - - 
- - - - - - - - - - - - - - - - 0 0 0 0 0 0 0 0 0 0 0 - - - - - - - - 
- - - - - - - - - - - - - - - - - - 0 0 0 0 0 0 0 - - - - - - - - - - 
28 30 0 <-> 9 38 4
28 34 1 <-> 29 32 4
30 34 1 <-> 31 31 4
26 34 1 <-> 27 32 4
28 34 4 <-> 28 36 0
28 36 4 <-> 28 38 0
21 32 3 <-> 23 34 7
22 30 3 <-> 24 32 7
30 17 1 <-> 31 15 4
27 15 4 <-> 28 17 7
25 14 2 <-> 27 14 6
27 12 3 <-> 28 14 0
31 13 7 <-> 30 11 4
30 5 1 <-> 9 2 6
25 17 0 <-> 33 15 2
25 27 4 <-> 33 16 2
28 39 4 <-> 19 42 4
29 39 4 <-> 20 42 4
27 36 6 <-> 24 36 2
29 36 2 <-> 32 26 2
10 6 2 <-> 14 7 0
26 28 5 <-> 34 17 1
3 9 1 <-> 18 16 2
23 24 2 <-> 25 24 6
25 24 2 <-> 27 24 6
23 25 2 <-> 25 25 6
25 25 2 <-> 27 25 6
23 26 2 <-> 25 26 6
25 26 2 <-> 27 26 6
30 25 2 <-> 32 25 6
32 24 6 <-> 30 24 2
30 27 2 <-> 32 27 6
30 28 2 <-> 32 28 6
30 32 3 <-> 32 34 7
22 38 2 <-> 32 37 2
22 39 2 <-> 32 38 2
15 40 4 <-> 33 36 4
1 19 6 <-> 34 19 2
