2
0
0 0
22 22
0 0 0 0 0 0 - - - - - - - - - - 0 0 0 0 0 0 
0 0 0 0 0 0 0 - - - - - - - - 0 0 0 0 0 0 0 
0 0 0 0 0 0 0 0 - - - - - - 0 0 0 0 0 0 0 0 
0 0 0 - 0 0 0 0 0 - - - - 0 0 0 0 0 - 0 0 0 
0 0 0 0 - 0 0 0 0 0 - - 0 0 0 0 0 - 0 0 0 0 
0 0 0 0 0 - 0 0 0 0 - - 0 0 0 0 - 0 0 0 0 0 
- 0 0 0 0 0 0 0 0 0 0 0 0 0 0 0 0 0 0 0 0 - 
- - 0 0 0 0 0 0 0 0 0 0 0 0 0 0 0 0 0 0 - - 
- - - 0 0 0 0 0 0 0 0 0 0 0 0 0 0 0 0 - - - 
- - - - 0 0 0 0 0 0 0 0 0 0 0 0 0 0 - - - - 
- - - - - - 0 0 0 0 1 2 0 0 0 0 - - - - - - 
- - - - - - 0 0 0 0 2 1 0 0 0 0 - - - - - - 
- - - - 0 0 0 0 0 0 0 0 0 0 0 0 0 0 - - - - 
- - - 0 0 0 0 0 0 0 0 0 0 0 0 0 0 0 0 - - - 
- - 0 0 0 0 0 0 0 0 0 0 0 0 0 0 0 0 0 0 - - 
- 0 0 0 0 0 0 0 0 0 0 0 0 0 0 0 0 0 0 0 0 - 
0 0 0 0 0 - 0 0 0 0 - - 0 0 0 0 - 0 0 0 0 0 
0 0 0 0 - 0 0 0 0 0 - - 0 0 0 0 0 - 0 0 0 0 
0 0 0 - 0 0 0 0 0 - - - - 0 0 0 0 0 - 0 0 0 
0 0 0 0 0 0 0 0 - - - - - - 0 0 0 0 0 0 0 0 
0 0 0 0 0 0 0 - - - - - - - - 0 0 0 0 0 0 0 
0 0 0 0 0 0 - - - - - - - - - - 0 0 0 0 0 0 
0 0 7 <-> 21 21 3
21 0 1 <-> 0 21 5
