2
2
2 1
9 23
- - - - - - - - - - - - - - - - - - - - - - - 
- - - - - - - - - - - - - - - - - - - - - - - 
- - - - - - - - - - - - - - - - - - - - - - - 
- - - - - - - 0 0 0 0 0 0 0 - - 0 0 0 0 0 0 0 
- - - - - - - x 0 0 0 0 0 0 - - 0 0 0 0 0 0 0 
- - - - - - - x 0 0 1 2 0 0 - - x 0 0 2 1 0 0 
- - - - - - - x 0 0 2 1 0 0 - - x 0 0 1 2 0 0 
- - - - - - - x 0 0 0 0 0 0 - - 0 0 0 0 0 0 0 
- - - - - - - 0 0 0 0 0 0 0 - - 0 0 0 0 0 0 0 
22 4 2 <-> 7 4 6
22 5 2 <-> 7 5 6
22 6 2 <-> 7 6 6
22 7 2 <-> 7 7 6
13 5 2 <-> 16 5 6
13 6 2 <-> 16 6 6
18 3 0 <-> 18 8 4
19 3 0 <-> 19 8 4
20 3 0 <-> 20 8 4
9 3 0 <-> 9 8 4
10 3 0 <-> 10 8 4
11 3 0 <-> 11 8 4
