2
0
0 1
15 25
- - - - - - - - - - - - - - - - - - - - - - - - - 
- - x x x x x x x x x x x x x x x x x x x x x x x 
- - x c b b b b b b b b i i b b b b b b b b b c x 
- - x b 0 0 0 0 0 0 0 0 0 0 0 0 0 0 0 0 0 0 0 b x 
- - x b 0 0 0 0 0 0 0 0 0 0 0 0 0 0 0 0 0 0 0 b x 
- - x b 0 0 0 0 0 0 0 0 0 0 0 0 0 0 0 0 0 0 0 b x 
- - x b 0 0 0 0 0 0 0 0 0 0 0 0 0 0 0 0 0 0 0 b x 
- - x b 0 0 0 0 0 0 0 0 1 2 0 0 0 0 0 0 0 0 0 b x 
- - x b 0 0 0 0 0 0 0 0 2 1 0 0 0 0 0 0 0 0 0 b x 
- - x b 0 0 0 0 0 0 0 0 0 0 0 0 0 0 0 0 0 0 0 b x 
- - x b 0 0 0 0 0 0 0 0 0 0 0 0 0 0 0 0 0 0 0 b x 
- - x b 0 0 0 0 0 0 0 0 0 0 0 0 0 0 0 0 0 0 0 b x 
- - x b 0 0 0 0 0 0 0 0 0 0 0 0 0 0 0 0 0 0 0 b x 
- - x c b b b b b b b b i i b b b b b b b b b c x 
- - x x x x x x x x x x x x x x x x x x x x x x x 
24 1 2 <-> 2 14 4
24 14 4 <-> 2 1 6
