2
3
1 2
20 20
- - - - - - 0 0 0 0 0 0 0 0 - - - - - -
- - - - 0 0 0 0 0 0 0 0 - - 0 0 - - - -
- - - 0 0 0 0 0 0 0 0 0 0 - - 0 0 - - -
- - 0 0 0 0 0 0 0 1 2 0 0 0 - 0 i 0 - -
- 0 0 0 0 0 0 0 0 2 1 0 0 0 - - 0 0 0 -
- 0 0 0 0 0 0 0 0 0 0 0 0 0 - - 0 0 0 -
0 0 0 0 0 0 0 0 0 0 0 0 0 - - 0 0 0 0 0
0 0 0 0 0 0 0 0 0 0 0 0 0 - - 0 0 0 0 0
0 0 0 0 0 0 0 0 0 0 0 0 - - 0 0 0 x 0 0
0 0 x 0 0 0 0 0 0 - i - - 0 0 0 x c x 0
0 x c x 0 0 0 - - i - 0 0 0 0 0 0 x 0 0
0 0 x 0 0 0 - - 0 0 0 0 0 0 0 0 0 0 0 0
0 0 0 0 0 - - 0 0 0 0 0 0 0 0 0 0 0 0 0
0 0 0 0 0 - - 0 0 0 0 0 0 0 0 0 0 0 0 0
- 0 0 0 - - 0 0 0 0 0 0 0 0 0 0 0 0 0 -
- 0 0 0 - - 0 0 0 2 1 0 0 0 0 0 0 0 0 -
- - 0 i 0 - 0 0 0 1 2 0 0 0 0 0 0 0 - -
- - - 0 0 - - 0 0 0 0 0 0 0 0 0 0 - - -
- - - - 0 0 - - 0 0 0 0 0 0 0 0 - - - -
- - - - - - 0 0 0 0 0 0 0 0 - - - - - -
6 0 0 <-> 8 19 4
7 0 0 <-> 9 19 4
8 0 0 <-> 10 19 4
9 0 0 <-> 11 19 4
10 0 0 <-> 12 19 4
11 0 0 <-> 13 19 4
0 6 6 <-> 19 6 2
0 7 6 <-> 19 7 2
0 8 6 <-> 19 8 2
0 9 6 <-> 19 9 2
0 10 6 <-> 19 10 2
0 11 6 <-> 19 11 2
0 12 6 <-> 19 12 2
0 13 6 <-> 19 13 2