2
0
0 0
8 8
b 0 0 0 0 0 0 b
0 0 0 0 0 0 0 0
0 0 0 0 0 0 0 0
0 0 b 1 2 0 0 0
0 0 0 2 1 b 0 0
0 0 0 0 0 0 0 0
0 0 0 0 0 0 0 0
b 0 0 0 0 0 0 b
7 2 2 <-> 0 2 6
7 3 2 <-> 0 3 6
7 4 2 <-> 0 4 6
7 5 2 <-> 0 5 6
