2
0
4 1
28 44
- - - - - - - - - - - - - - - - - - - - - - - - - - - - - - - - - - - - - - - - - - - - 
0 0 0 0 0 - - - - - - 0 0 0 0 0 0 0 0 0 0 0 0 0 0 0 0 0 0 0 0 0 0 0 0 0 - - b 0 0 0 0 b 
0 0 0 0 0 - - - - - - 0 0 0 0 0 0 0 0 0 0 0 0 0 0 0 0 0 0 0 0 0 0 0 0 0 - - 0 0 0 0 0 0 
0 0 0 0 0 - - - - - - 0 0 0 0 0 0 0 0 0 0 0 0 0 0 0 0 0 0 0 0 0 0 0 0 0 - - 0 0 0 0 0 0 
0 0 0 0 0 0 0 0 0 0 0 0 0 0 - - - - - - - - - - - - 0 0 0 0 - - - - - - - - 0 0 0 0 0 0 
- 0 0 0 0 0 0 0 0 0 0 0 0 0 - - - - - - - - - - - - 0 0 0 0 - - - - - - - - 0 0 0 0 0 0 
- 0 0 0 1 2 0 0 0 0 0 0 0 0 - - - - - - - - - - - - 0 0 0 0 - - - - - - - - 0 0 0 0 0 0 
- 0 0 0 2 1 0 0 0 0 0 0 c 0 0 0 0 0 0 0 0 0 0 0 0 0 0 0 0 0 c 0 0 0 - - - - 0 0 0 0 0 0 
- 0 0 0 0 0 0 0 - 0 0 c 0 0 0 0 0 0 0 0 0 i 0 0 0 0 0 0 0 0 0 c 0 0 0 0 0 0 0 0 0 0 0 0 
- 0 0 0 0 0 0 0 - 0 c 0 0 0 0 0 0 0 0 0 0 0 0 0 0 0 0 0 0 0 0 0 c 0 0 0 0 0 0 0 0 0 0 0 
- 0 0 0 - - - - - - - - - - - - - - - - - - - - - - 0 0 0 0 - - - - 0 0 0 - 0 0 0 0 0 0 
- 0 0 0 - - - - - - - - - - - - - - - - - - - - - - 0 0 0 - - - - - 0 0 0 - 0 0 0 0 0 0 
- 0 0 0 0 0 0 - - - - - - - - - - - - - - - - - - 0 0 0 0 - - - - - 0 0 0 - b 0 0 0 0 b 
- 0 0 0 0 0 0 0 0 0 0 0 0 0 0 0 0 0 0 0 0 0 0 0 0 0 0 0 0 0 0 0 - - 0 0 0 - - - - 0 0 - 
- 0 0 0 0 0 0 x x x x x x x x x x x x x x x x x x x x x x x x x - - 0 0 0 - - - - 0 0 - 
- 0 0 0 0 0 0 0 0 0 0 0 0 0 0 0 0 0 0 0 0 0 0 0 0 0 0 0 0 0 0 0 - - 0 0 0 - - - - 0 0 - 
- 0 0 0 0 0 0 - - - - - - - - - - - - - - - - - - 0 0 0 0 - - - - - 0 0 0 - b 0 0 0 0 b 
- 0 0 0 - - - - - - - - - - - - - - - - - - - - - - 0 0 0 - - - - - 0 0 0 - 0 0 0 0 0 0 
- 0 0 0 - - - - - - - - - - - - - - - - - - - - - - 0 0 0 0 - - - - 0 0 0 - 0 0 0 0 0 0 
- 0 0 0 0 0 0 0 - 0 c 0 0 0 0 0 0 0 0 0 0 0 0 0 0 0 0 0 0 0 0 0 c 0 0 0 0 0 0 0 0 0 0 0 
- 0 0 0 0 0 0 0 - 0 0 c 0 0 0 0 0 0 0 0 0 i 0 0 0 0 0 0 0 0 0 c 0 0 0 0 0 0 0 0 0 0 0 0 
- 0 0 0 0 0 0 0 0 0 0 0 c 0 0 0 0 0 0 0 0 0 0 0 0 0 0 0 0 0 c 0 0 0 - - - - 0 0 0 0 0 0 
- 0 0 0 0 0 0 0 0 0 0 0 0 0 - - - - - - - - - - - - 0 0 0 0 - - - - - - - - 0 0 0 0 0 0 
- 0 0 0 0 0 0 0 0 0 0 0 0 0 - - - - - - - - - - - - 0 0 0 0 - - - - - - - - 0 0 0 0 0 0 
0 0 0 0 0 0 0 0 0 0 0 0 0 0 - - - - - - - - - - - - 0 0 0 0 - - - - - - - - 0 0 0 0 0 0 
0 0 0 0 0 - - - - - - 0 0 0 0 0 0 0 0 0 0 0 0 0 0 0 0 0 0 0 0 0 0 0 0 0 - - 0 0 0 0 0 0 
0 0 0 0 0 - - - - - - 0 0 0 0 0 0 0 0 0 0 0 0 0 0 0 0 0 0 0 0 0 0 0 0 0 - - 0 0 0 0 0 0 
0 0 0 0 0 - - - - - - 0 0 0 0 0 0 0 0 0 0 0 0 0 0 0 0 0 0 0 0 0 0 0 0 0 - - b 0 0 0 0 b 
4 2 2 <-> 11 2 6
4 3 2 <-> 11 3 6
4 25 2 <-> 11 25 6
4 26 2 <-> 11 26 6
35 26 2 <-> 41 27 4
35 27 2 <-> 38 21 6
35 1 2 <-> 38 7 6
35 2 2 <-> 41 1 0
43 19 2 <-> 24 21 4
43 24 2 <-> 18 21 4
9 19 0 <-> 7 15 4
11 19 0 <-> 9 15 4
33 19 0 <-> 31 15 4
31 19 0 <-> 29 15 4
25 19 0 <-> 15 15 4
17 19 0 <-> 23 15 4
9 9 4 <-> 7 13 0
11 9 4 <-> 9 13 0
33 9 4 <-> 31 13 0
31 9 4 <-> 29 13 0
43 4 2 <-> 18 7 0
43 9 2 <-> 24 7 0
25 9 4 <-> 15 13 0
17 9 4 <-> 23 13 0
4 1 1 <-> 11 1 6
4 27 3 <-> 11 27 6
35 25 2 <-> 40 16 0
35 3 2 <-> 40 12 4
38 18 6 <-> 25 21 4
38 25 6 <-> 19 21 4
38 3 6 <-> 19 7 0
38 10 6 <-> 25 7 0
24 19 0 <-> 22 15 4
18 19 0 <-> 16 15 4
18 9 4 <-> 16 13 0
24 9 4 <-> 22 13 0
3 27 4 <-> 33 25 0
2 27 4 <-> 32 27 4
1 27 5 <-> 21 27 3
3 1 0 <-> 33 3 4
2 1 0 <-> 32 1 0
1 1 7 <-> 21 1 1
15 25 0 <-> 14 21 4
17 25 0 <-> 15 21 4
14 7 0 <-> 15 3 4
15 7 0 <-> 17 3 4
14 19 7 <-> 30 15 3
30 13 1 <-> 14 9 5
