2
2
0 2
15 15
x 0 0 0 0 0 0 0 0 0 0 0 0 0 0
0 0 0 0 0 0 0 0 0 0 0 0 0 0 0
0 0 b 0 0 0 0 0 0 0 0 1 2 0 0
0 0 0 0 0 0 0 0 0 0 0 2 1 0 0
0 0 0 0 b 0 0 0 0 0 0 0 0 0 0
x 0 0 0 0 0 0 0 0 0 0 0 0 0 x
x 0 0 0 0 0 b 0 0 0 0 0 0 0 x
x 0 0 0 0 0 0 b 0 0 0 0 0 0 x
x 0 0 0 0 0 0 0 0 0 0 0 0 0 x
0 0 0 0 0 0 0 0 0 b 0 0 0 0 0
0 0 0 0 0 0 0 0 0 0 0 0 0 0 0
0 0 2 1 0 0 0 0 0 0 0 b 0 0 0
0 0 1 2 0 0 0 0 0 0 0 0 0 0 0
0 0 0 0 0 0 0 0 0 0 0 0 0 0 0
0 0 0 0 0 0 0 0 0 0 0 0 0 0 x