2
4
0 0
15 15
0 c - - - - - - - - - - - 0 0
0 0 0 0 - - - - - - - 0 0 0 0
0 0 0 0 0 - - - - - 0 0 0 0 0
0 0 - - 0 0 - - - 0 0 - - 0 0
0 0 0 - 0 0 - - - 0 0 - 0 0 0
0 0 0 0 0 0 0 - 0 0 0 0 0 0 0
1 0 0 - 0 0 0 - 0 0 0 - 0 0 2
2 0 - - - 0 b - b 0 - - - 0 1
1 0 0 - 0 0 0 - 0 0 0 - 0 0 2
0 0 0 0 0 0 0 - 0 0 0 0 0 0 0
0 0 0 - 0 0 - - - 0 0 - 0 0 0
0 0 - - 0 0 - - - 0 0 - - 0 0
0 0 0 0 0 - - - - - 0 0 0 0 0
0 0 0 0 - - - - - - - 0 0 0 0
0 0 - - - - - - - - - - - c 0
0 0 6 <-> 14 0 2
0 1 6 <-> 14 1 2
0 2 6 <-> 14 2 2
0 3 6 <-> 14 3 2
0 4 6 <-> 14 4 2
0 5 6 <-> 14 5 2
0 6 6 <-> 14 6 2
0 7 6 <-> 14 7 2
0 8 6 <-> 14 8 2
0 9 6 <-> 14 9 2
0 10 6 <-> 14 10 2
0 11 6 <-> 14 11 2
0 12 6 <-> 14 12 2
0 13 6 <-> 14 13 2
0 14 6 <-> 14 14 2