2
2
3 2
16 20
- - - - - 0 0 0 0 0 0 0 0 0 0 - - - - -
- - - - 0 0 0 0 0 2 1 0 0 0 0 0 - - - -
- - - 0 0 0 0 0 0 1 2 0 0 0 0 0 0 - - -
- - 0 0 0 0 0 0 0 0 0 0 0 0 0 0 0 0 - -
- 0 0 0 0 0 0 0 0 - - 0 0 0 0 0 0 0 0 -
0 0 0 0 0 0 0 0 - - - - 0 0 0 0 0 0 0 0
0 0 0 0 0 0 0 - - b i - - 0 0 0 0 0 0 0
c - - - - - - - - - - - - - - - - - - b
b - - - - - - - - - - - - - - - - - - c
0 0 0 0 0 0 0 - - i b - - 0 0 0 0 0 0 0
0 0 0 0 0 0 0 0 - - - - 0 0 0 0 0 0 0 0
- 0 0 0 0 0 0 0 0 - - 0 0 0 0 0 0 0 0 -
- - 0 0 0 0 0 0 0 0 0 0 0 0 0 0 0 0 - -
- - - 0 0 0 0 0 0 2 1 0 0 0 0 0 0 - - -
- - - - 0 0 0 0 0 1 2 0 0 0 0 0 - - - -
- - - - - 0 0 0 0 0 0 0 0 0 0 - - - - -
1 6 4 <-> 1 9 0
2 6 4 <-> 2 9 0
3 6 4 <-> 3 9 0
4 6 4 <-> 4 9 0
5 6 4 <-> 5 9 0
6 6 4 <-> 6 9 0
13 6 4 <-> 13 9 0
14 6 4 <-> 14 9 0
15 6 4 <-> 15 9 0
16 6 4 <-> 16 9 0
17 6 4 <-> 17 9 0
18 6 4 <-> 18 9 0
6 6 2 <-> 9 6 6
10 6 2 <-> 13 6 6
6 9 2 <-> 9 9 6
10 9 2 <-> 13 9 6