2
1
2 1
11 20
0 0 0 0 0 0 0 0 0 0 0 0 0 0 0 0 - 0 0 0 
0 0 - - 0 0 0 x x x 0 0 0 0 0 0 - b 0 0 
0 0 - 0 0 0 0 0 0 0 0 0 0 - 0 0 - - - - 
0 0 - c 0 0 0 0 - 0 0 0 0 0 0 0 - x x x 
0 0 0 0 0 0 0 - 0 - 0 0 0 0 0 0 - x 0 x 
0 0 0 0 0 0 0 - 0 - 0 0 0 0 0 0 0 x x x 
0 0 0 0 0 0 0 0 c 0 0 0 0 1 2 0 0 0 x 0 
- - - 0 0 0 0 0 0 0 0 0 0 2 1 0 0 0 x 0 
- - - - 0 0 0 0 0 0 0 0 0 x x 0 0 x x x 
- - - 0 b 0 0 0 0 0 0 0 0 0 0 0 0 0 x 0 
0 0 0 0 0 0 0 0 0 0 0 0 0 0 0 0 0 x 0 x 
8 4 0 <-> 19 1 2
0 10 6 <-> 3 2 0