2
2
2 2
16 28
1 2 0 0 0 0 0 0 0 0 0 0 0 0 0 0 0 0 0 0 0 0 0 0 0 0 1 2 
2 1 0 0 0 0 0 0 0 0 0 0 0 0 0 0 0 0 0 0 0 0 0 0 0 0 2 1 
1 2 0 0 0 0 0 0 0 0 0 0 0 0 0 0 0 0 0 0 0 0 0 0 0 0 1 2 
2 1 0 0 0 0 0 0 0 0 0 0 0 0 0 0 0 0 0 0 0 0 0 0 0 0 2 1 
1 2 0 0 0 0 0 0 0 0 0 0 0 0 0 0 0 0 0 0 0 0 0 0 0 0 1 2 
2 1 0 0 0 0 0 0 0 0 0 x 0 0 x 0 0 x 0 0 0 0 0 0 0 0 2 1 
1 2 0 0 0 0 0 0 0 0 0 0 x 0 x 0 x 0 0 0 0 0 0 0 0 0 1 2 
2 1 0 0 0 0 0 0 0 0 0 0 0 x x x 0 0 0 0 0 0 0 0 0 0 2 1 
1 2 0 0 0 0 0 0 0 0 0 x x x x x x x 0 0 0 0 0 0 0 0 1 2 
2 1 0 0 0 0 0 0 0 0 0 0 0 x x x 0 0 0 0 0 0 0 0 0 0 2 1 
1 2 0 0 0 0 0 0 0 0 0 0 x 0 x 0 x 0 0 0 0 0 0 0 0 0 1 2 
2 1 0 0 0 0 0 0 0 0 0 x 0 0 x 0 0 x 0 0 0 0 0 0 0 0 2 1 
1 2 0 0 0 0 0 0 0 0 0 0 0 0 0 0 0 0 0 0 0 0 0 0 0 0 1 2 
2 1 0 0 0 0 0 0 0 0 0 0 0 0 0 0 0 0 0 0 0 0 0 0 0 0 2 1 
1 2 0 0 0 0 0 0 0 0 0 0 0 0 0 0 0 0 0 0 0 0 0 0 0 0 1 2 
2 1 0 0 0 0 0 0 0 0 0 0 0 0 0 0 0 0 0 0 0 0 0 0 0 0 2 1 
