2
5
1 3
25 24
- - - - 0 0 0 0 0 0 0 0 0 0 0 0 0 0 0 0 - - - -
- - - 0 0 0 0 0 0 0 0 0 0 0 0 0 0 0 0 0 0 - - -
- - 0 0 0 0 0 0 0 0 0 0 0 0 0 0 0 0 0 0 0 0 - -
- 0 0 0 0 0 0 0 0 0 0 0 0 0 0 0 0 0 0 0 0 0 0 -
0 0 0 0 0 0 0 0 0 0 0 0 0 0 0 0 0 0 0 0 0 0 0 0
0 0 0 0 0 i i i 0 0 0 0 0 0 0 0 i i i 0 0 0 0 0
0 0 0 0 0 i b i 0 0 0 0 0 0 0 0 i b i 0 0 0 0 0
0 0 0 0 0 i i i 0 0 0 0 0 0 0 0 i i i 0 0 0 0 0
0 0 0 0 0 0 0 0 0 0 0 0 0 0 0 0 0 0 0 0 0 0 0 0
0 0 0 0 0 0 0 0 0 0 0 1 2 0 0 0 0 0 0 0 0 0 0 0
0 0 0 0 0 0 0 0 0 0 0 2 1 0 0 0 0 0 0 0 0 0 0 0
0 0 0 0 0 0 0 0 2 1 0 0 0 0 1 2 0 0 0 0 0 0 0 0
0 0 0 0 0 0 0 0 1 2 0 0 0 0 2 1 0 0 0 0 0 0 0 0
0 0 0 0 0 0 0 0 0 0 0 0 0 0 0 0 0 0 0 0 0 0 0 0
0 0 0 0 0 0 0 0 0 0 0 2 1 0 0 0 0 0 0 0 0 0 0 0
- 0 0 0 0 0 0 0 0 0 0 1 2 0 0 0 0 0 0 0 0 0 0 -
- - 0 0 0 0 0 0 0 0 0 0 0 0 0 0 0 0 0 0 0 0 - -
- - - - 0 0 0 0 0 0 0 0 0 0 0 0 0 0 0 0 - - - -
- - - - x x c c x x c c x x c c x x c c - - - -
- - - - x x c c x x c c x x c c x x c c - - - -
- - - - c c x x c c x x c c x x c c x x - - - -
- - - - - c x x c c x x c c x x c c x - - - - -
- - - - - - 0 0 0 0 0 0 0 0 0 0 0 0 - - - - - -
- - - - - - - 0 0 0 0 0 0 0 0 0 0 - - - - - - -
- - - - - - - - 0 0 0 0 0 0 0 0 - - - - - - - -
4 0 7 <-> 15 24 3
3 1 7 <-> 16 23 3
2 2 7 <-> 17 22 3
1 3 7 <-> 18 21 3
0 4 7 <-> 19 20 3
19 0 1 <-> 8 24 5
20 1 1 <-> 7 23 5
21 2 1 <-> 6 22 5
22 3 1 <-> 5 21 5
23 4 1 <-> 4 20 5