2
0
2 2
29 31
0 0 0 0 0 0 0 0 0 0 0 0 0 0 0 0 0 0 - - - - - - - - 0 0 0 - - 
0 0 0 1 2 0 0 0 0 0 0 0 0 0 0 0 0 0 - - - - - - - - 0 0 0 - - 
0 0 0 2 1 0 0 0 0 0 - - - - 0 0 0 0 - - - - - - - - 0 0 c 0 0 
0 0 0 0 0 0 0 0 0 0 0 0 0 0 0 0 0 0 0 0 0 0 0 0 0 0 0 0 0 0 0 
- - - 0 0 0 0 0 0 0 0 0 0 0 0 0 0 0 0 0 0 2 1 0 0 0 0 0 0 0 0 
- - - - - 0 0 0 0 0 0 0 0 0 0 0 0 0 0 0 0 1 2 0 0 0 0 0 0 0 0 
0 0 0 - - 0 0 0 0 0 0 0 0 0 0 0 0 0 0 0 0 0 0 0 0 0 0 0 0 - - 
0 0 0 - - 0 0 0 0 0 0 - - - 0 0 0 - - - 0 0 - - - - 0 0 0 - - 
0 0 0 - - 0 0 0 0 0 0 - - - 0 0 0 - - - 0 0 - - - - 0 0 0 - - 
0 0 0 - - 0 0 0 0 0 0 - - - 0 0 0 - - - 0 0 - - - - 0 0 0 - - 
0 0 0 - - 0 0 0 0 0 0 - - - 0 0 0 - - - 0 0 - - - - 0 0 0 - - 
0 0 0 - - 0 0 0 0 0 0 - - - 0 0 0 - 0 0 i i 0 0 0 - 0 0 0 - - 
0 0 0 - - 0 0 0 0 0 0 - - - b 0 0 - 0 0 0 0 0 0 0 - 0 0 0 - - 
0 0 0 - - 0 0 0 0 0 0 - - - b 0 0 - 0 0 0 0 0 0 0 - 0 0 0 0 0 
0 0 0 - - 0 0 0 0 0 0 - - - 0 0 0 - - - - - - - - - 0 0 0 i 0 
0 0 0 0 - - 0 0 0 0 0 - - - 0 0 0 - - - - - - - - 0 0 0 0 0 0 
0 0 0 0 - - 0 0 0 0 0 - - - 0 0 0 - - - - - - - 0 0 0 0 0 0 0 
0 0 0 0 - - 0 0 0 0 0 - - - 0 0 0 0 0 b b 0 0 0 0 0 0 0 0 - - 
c 0 0 0 - - 0 0 0 0 0 - - - 0 0 0 0 0 0 0 0 0 0 0 0 0 0 0 - - 
0 0 0 0 - - 0 0 0 0 0 - - - 0 0 0 0 - - 0 0 0 0 0 0 0 0 0 - - 
0 0 0 0 - - 0 0 0 0 0 - - - 0 0 0 0 - - 0 0 0 0 - - 0 0 0 - - 
0 0 0 0 - - 0 0 0 0 0 - - - 0 0 0 0 0 0 0 0 0 0 - - 0 0 0 0 0 
0 0 0 0 - - 0 0 0 0 0 0 0 0 0 0 0 0 0 0 0 0 0 0 0 0 0 0 0 0 0 
0 0 0 0 - - 0 0 0 0 0 0 0 0 0 0 0 0 0 0 0 0 0 0 0 0 0 0 0 0 0 
0 0 0 0 - - 0 0 0 0 0 - - - 0 0 - - - - - - - - - 0 0 - - 0 0 
0 0 0 0 - - 0 0 0 0 0 - - - 0 0 - - - - - - - - - 0 0 - - 0 0 
0 0 0 c - - 0 2 1 0 0 - - - 0 0 - - - - - - - - - 0 0 0 0 0 0 
0 0 0 0 - - 0 1 2 0 0 - - - - - - - - - - - - - - 0 0 1 2 0 0 
0 0 0 0 - - 0 0 0 0 0 - - - - - - - - - - - - - - 0 0 2 1 0 0 
18 11 6 <-> 16 11 2
18 12 6 <-> 16 12 2
3 4 5 <-> 2 6 0
16 15 2 <-> 24 16 7
25 26 6 <-> 15 26 2
25 27 6 <-> 10 27 2
14 18 6 <-> 10 18 2
3 22 2 <-> 6 22 6
24 6 4 <-> 24 11 0
24 12 2 <-> 26 12 6
30 5 4 <-> 30 13 0
29 5 4 <-> 29 13 0
30 16 4 <-> 30 21 0
29 16 4 <-> 29 21 0
6 21 6 <-> 3 21 2
14 10 6 <-> 12 6 4
5 8 6 <-> 2 8 2
6 23 6 <-> 3 23 2
6 16 7 <-> 2 13 3
