2
3
3 1
32 48
- - - - - - - - - - - - - - - - - - - - - - - - - - - - - - - - - - - - - - - - - - - - - - - - 
- - - - - - - - - - - - - - - - - - - - - - - - - - - - - - - - - - - - - - - - - - - - - - - - 
- - - - - - - - - - - - - - x x - - - 0 0 0 - - - - - - - - - - - - - - - - - - - - - - - - - - 
- - - - - - - - - - - - - 0 0 0 0 - - 0 0 0 - - - - - - - - - - - - - - - - - - - - - - - - - - 
- - - - - - - - - - - - 0 0 0 0 0 0 - 0 - 0 - - - - - - - - - - - - - - - - - - - - - - - - - - 
- - - - - - - - - - - 0 0 0 - - 0 0 0 0 - 0 - - - - - - - - - - - - - - - - - - - - - - - - - - 
- - - - - - - - - - 0 0 0 - - - - 0 0 0 - 0 - - - - - - - - - - - - - - - - - - - - - - - - - - 
- - - - - - - - - 0 0 0 - - - - - - 0 0 0 0 - - - - - - - - - - - - - - - - - - - - - - - - - - 
- - - - - - - - 0 0 0 - - - - - - - - 0 0 0 - - - - - - - - - - - - - - - - - - - - - - - - - - 
- - - - - - - 0 0 0 - - - - - - - - - - 0 0 0 - - - - - - - - - - - - - - - - - - - - - - - - - 
- - - - - - 0 0 0 - - - - - - - - - - - - 0 0 0 - - - - - - - - - - - - - - - - - - - - - - - - 
- - - - - 0 0 0 - - - - - - - - - - - - - - 0 0 0 - - - - - - - - - - - - - - - - - - - - - - - 
- - - - 0 0 0 - - - - - - - - - - - - - - - - 0 0 0 - - - - - - - - - - - - - - - - - - - - - - 
- - - 0 0 0 0 0 0 0 0 0 0 b b b b 0 0 0 0 0 0 0 0 0 0 - - - - - - - - - - - - - - - - - - - - - 
- - 0 0 0 0 0 0 0 0 0 0 0 0 0 0 0 0 0 0 0 0 0 0 0 0 0 0 - - - - - - - - - - - - - - - - - - - - 
- 0 0 0 0 0 0 - - - - - - - - - - - - - - - - 0 0 0 0 0 0 - - - - - - - - - - - - - - - - - - - 
- 0 0 - 0 0 0 - - - - - - - - - - - - - - - - 0 0 0 - 0 0 - - - - - - - - - - - - - - - - - - - 
- - - - 0 0 0 - - 0 0 0 0 - - - - 0 0 0 0 - - 0 0 0 - - - - - - - - - - - - - - - - - - - - - - 
- - - - 0 0 0 - - 0 - - 0 - - - - 0 - - 0 - - 0 0 0 - - - - - - - - - - - - - - - - - - - - - - 
- - - - 0 0 0 - - 0 - - 0 - - - - 0 - - 0 - - 0 0 0 - - - - - - - - - - - - - - - - - - - - - - 
- - - - 0 0 0 - - 0 0 0 c - - - - c 0 0 0 - - 0 0 0 - - - - - - - - - - - - - - - - - - - - - - 
- - - - 0 0 0 - - - - - - - - - - - - - - - - 0 0 0 - - - - - - - - - - - - - - - - - - - - - - 
- - - - 0 0 0 - - - - - - - - - - - - - - - - 0 0 0 - - - - - - - - - - - - - - - - - - - - - - 
- - - - 0 0 0 - - - - - - - - - - - - - - - - 0 0 0 - - - - - - - - - - - - - - - - - - - - - - 
- - - - 0 0 0 - - - - - - i 0 0 0 i - - - - - 0 0 0 - - - - - - - - - - - - - - - - - - - - - - 
- - - - 0 0 0 - - - - - - 0 - - - 0 - - - - - 0 0 0 - - - - - - - - - - - - - - - - - - - - - - 
- - - - 0 0 0 - - - - - - 0 - - - 0 - - - - - 0 0 0 - - - - - - - - - - - - - - - - - - - - - - 
- - - - 0 0 0 - - - - - - 0 - - x 0 - - - - - 0 0 0 - 0 - 0 - 0 - 0 - 0 - 0 - 0 - 0 - - - - - - 
- - - - 0 0 0 - - - - - - 0 - - - 0 - - - - - 0 0 0 - 0 - 0 - 0 - 0 - 0 - 0 - 0 - 0 - - - - - - 
- - - - 0 1 2 - - - - - - 0 - - - 0 - - - - - 1 2 0 - 0 - 0 - 0 - 0 - 0 - 0 - 0 - 0 - - - - - - 
- - - - 0 2 1 0 0 0 0 0 0 0 0 0 0 0 0 0 0 0 0 2 1 0 0 0 0 0 0 0 0 0 0 0 0 0 0 0 0 0 0 0 0 0 0 0 
- - - - 0 0 0 0 0 0 0 0 0 0 0 0 0 0 0 0 0 0 0 0 0 0 0 0 0 0 0 0 0 0 0 0 0 0 0 0 0 0 0 0 0 0 0 0 
12 17 2 <-> 17 17 6
13 24 7 <-> 12 20 4
17 24 1 <-> 17 20 4
9 20 6 <-> 6 20 2
20 20 2 <-> 23 20 6
27 27 0 <-> 29 27 0
31 27 0 <-> 33 27 0
35 27 0 <-> 37 27 0
39 27 0 <-> 41 27 0
