2
2
1 1
6 8
0 - - - - - - 0
- c 0 0 0 0 c -
- x 0 1 2 0 0 -
- 0 0 2 1 0 x -
- c 0 0 0 0 c -
0 - - - - - - 0