2
1
1 0
9 9
0 0 0 0 0 0 0 0 0
0 1 2 0 0 0 1 2 0
0 1 2 0 0 0 1 2 0
0 0 0 0 b 0 0 0 0
0 0 0 c 0 i 0 0 0
0 0 0 0 x 0 0 0 0
0 2 1 0 0 0 2 1 0
0 2 1 0 0 0 2 1 0
0 0 0 0 0 0 0 0 0
4 0 0 <-> 4 8 4
0 4 6 <-> 8 4 2
