2
8
2 2
17 15
- - - - - - - i - - - - - - -
- - - - - - 0 x 0 - - - - - -
- - - - - 0 0 0 0 0 - - - - -
- - - - 0 0 0 0 0 0 0 - - - -
- - - 0 x 0 0 0 0 i 0 0 - - -
- - 0 0 0 0 0 0 0 0 0 0 0 - -
- 0 0 i 0 0 0 0 0 0 0 0 0 0 -
0 0 0 0 0 0 1 2 0 0 0 0 0 0 0
0 0 0 0 0 0 2 1 0 0 0 0 0 0 0
0 0 0 0 0 0 0 0 0 0 0 0 0 0 0
- 0 i 0 0 0 0 0 0 c 0 0 0 0 -
- - 0 0 0 0 0 0 0 0 0 0 i - -
- - - 0 0 0 0 0 0 i 0 0 - - -
- - - - 0 i 0 0 0 0 0 - - - -
- - - - - 0 0 0 0 0 - - - - -
- - - - - - 0 0 0 - - - - - -
- - - - - - - b - - - - - - -
5 2 6 <-> 4 3 6
