2
3
0 2
12 12
- x - 0 - 0 0 - 0 - 0 -
x x 0 0 0 b b 0 0 0 0 0
- 0 - 0 - b b - 0 - 0 -
0 0 0 0 b b b b 0 0 0 0
- 0 - c - b b - x - 0 -
0 0 0 0 0 1 2 0 0 0 0 0
0 0 0 0 0 2 1 0 0 0 0 0
- 0 - c - 0 0 - x - 0 -
0 0 0 0 i 0 0 i 0 0 0 0
- 0 - 0 - 0 0 - 0 - 0 -
0 0 0 0 0 0 0 0 0 0 x x
- 0 - 0 - 0 0 - 0 - x -
6 0 0 <-> 10 0 0
0 6 6 <-> 0 10 6
6 11 4 <-> 8 11 4
11 6 2 <-> 11 8 2
11 3 2 <-> 11 3 2
