2
0
0 0
11 13
i c 0 0 0 0 0 0 - - - - - 
c i 0 0 0 0 0 0 - - - - - 
0 0 0 0 0 0 0 0 - - - - - 
0 0 0 0 0 0 0 0 - - - - - 
0 0 0 0 0 0 0 0 - - - - - 
0 0 0 0 0 0 2 1 0 0 0 0 0 
0 0 0 0 0 0 1 2 0 0 0 0 0 
- - - - - - 0 0 0 0 0 0 0 
- - - - - - 0 0 0 0 0 0 0 
- - - - - - 0 0 0 0 0 i c 
- - - - - - 0 0 0 0 0 c i 
7 4 2 <-> 8 5 0
5 6 4 <-> 6 7 6
4 6 4 <-> 6 8 6
7 3 2 <-> 9 5 0
