2
10
0 0
9 11
- - - - - - - - - - - 
- - 0 0 0 - - - 0 0 0 
- - 0 1 2 - - - 0 0 0 
- - 0 2 1 - - - 0 0 0 
- - - - - - - - - - - 
- - 0 - - - - - - - 0 
- - x 0 0 - - - 0 0 x 
- - 0 0 0 x x x 0 0 0 
- - - - 0 x x x 0 - - 
4 1 2 <-> 8 1 6
4 2 2 <-> 8 2 6
4 3 2 <-> 8 3 6
3 3 4 <-> 9 3 4
3 1 0 <-> 9 1 0
