2
0
0 0
9 15
c c c - - - i i i - - - c c c 
0 0 0 - - - 0 0 0 - - - 0 0 0 
0 0 0 - - - 0 0 0 - - - 0 0 0 
0 0 0 0 0 0 0 0 0 0 0 0 0 0 0 
0 2 1 0 0 0 0 0 0 0 0 0 1 2 0 
0 1 2 0 0 0 0 0 0 0 0 0 2 1 0 
0 0 0 - - - 0 0 0 - - - 0 0 0 
0 0 0 - - - 0 0 0 - - - 0 0 0 
i i i - - - c c c - - - i i i 
