2
6
6 2
13 23
- - 0 0 0 0 0 0 0 - - - 0 0 0 0 0 0 0 - - - -
- - 0 0 0 0 0 0 0 - - - 0 0 0 0 0 0 0 - - - -
- - 0 0 0 0 0 0 0 - - - 0 0 0 0 0 0 0 - - - -
- - 0 0 0 0 0 0 0 0 0 0 0 0 0 0 0 0 0 - - - -
- - 0 0 0 0 0 0 0 0 0 0 0 0 0 0 0 0 0 - - - - 
- - - - - - - - 0 0 1 2 0 0 - - - - - - - - -
- - - - - - - - 0 0 2 1 0 0 - - - - - - - - -
- - - - - - - - 0 0 0 0 0 0 - - - - - - - - -
- - 0 0 0 0 0 0 0 0 0 0 0 0 0 0 0 0 0 - - - -
- - 0 0 0 0 0 0 0 - - - 0 0 0 0 0 0 0 - - - -
- - 0 x x 0 0 0 0 - - - 0 0 0 x x 0 0 - - - -
- - 0 x x 0 0 0 0 - - - 0 0 0 x x 0 0 - - - -
- - 0 0 0 0 0 0 0 - - - 0 0 0 0 0 0 0 - - - -