2
6
1 1
30 21
0 0 0 0 0 0 - - - - - - - - - 0 0 0 0 0 0
0 0 1 2 0 0 - - - - - - - - - 0 0 2 1 0 0
0 0 2 1 0 0 - - - - - - - - - 0 0 1 2 0 0
0 0 0 0 0 0 - - - - - - - - - 0 0 0 0 0 0
- - - 0 0 0 0 0 0 - - - 0 0 0 0 0 0 - - -
- - - 0 0 1 2 0 0 - - - 0 0 2 1 0 0 - - -
- - - 0 0 2 1 0 0 - - - 0 0 1 2 0 0 - - -
- - - 0 0 0 0 0 0 - - - 0 0 0 0 0 0 - - -
- - - - - - 0 0 0 x x x x 0 0 - - - - - -
- - - - - - 0 0 0 x 1 2 x 0 0 - - - - - -
- - - - - - 0 0 0 x 2 1 x 0 0 - - - - - -
- - - - - - 0 0 0 x x x x 0 0 - - - - - -
i 0 0 0 0 0 0 0 0 0 0 0 0 0 0 0 0 0 0 0 i
0 0 0 0 b 0 0 0 0 0 0 0 0 0 0 0 b 0 0 0 0
c 0 0 0 b 0 0 0 0 0 1 2 0 0 0 0 b 0 0 0 c
c 0 0 0 b 0 0 0 0 0 2 1 0 0 0 0 b 0 0 0 c
0 0 0 0 b 0 0 0 0 0 0 0 0 0 0 0 b 0 0 0 0
i 0 0 0 0 0 0 0 0 0 0 0 0 0 0 0 0 0 0 0 i
- - - - - - 0 0 0 x x x x 0 0 - - - - - -
- - - - - - 0 0 0 x 1 2 x 0 0 - - - - - -
- - - - - - 0 0 0 x 2 1 x 0 0 - - - - - -
- - - - - - 0 0 0 x x x x 0 0 - - - - - -
- - - 0 0 0 0 0 0 - - - 0 0 0 0 0 0 - - -
- - - 0 0 1 2 0 0 - - - 0 0 2 1 0 0 - - -
- - - 0 0 2 1 0 0 - - - 0 0 1 2 0 0 - - -
- - - 0 0 0 0 0 0 - - - 0 0 0 0 0 0 - - -
0 0 0 0 0 0 - - - - - - - - - 0 0 0 0 0 0
0 0 1 2 0 0 - - - - - - - - - 0 0 2 1 0 0
0 0 2 1 0 0 - - - - - - - - - 0 0 1 2 0 0
0 0 0 0 0 0 - - - - - - - - - 0 0 0 0 0 0
0 0 0 <-> 0 29 4
1 0 0 <-> 1 29 4
2 0 0 <-> 2 29 4
3 0 0 <-> 3 29 4
4 0 0 <-> 4 29 4
5 0 0 <-> 5 29 4
15 0 0 <-> 15 29 4
16 0 0 <-> 16 29 4
17 0 0 <-> 17 29 4
18 0 0 <-> 18 29 4
19 0 0 <-> 19 29 4
20 0 0 <-> 20 29 4
