2
1
1 1
33 33
c x c x c x c x c x c x c x 1 - i - 2 x c x c x c x c x c x c x c
x - - - - - - - - - - - - - - - - - - - - - - - - - - - - - - - x
c - 0 0 0 0 0 0 0 0 0 0 0 0 0 0 0 0 0 0 0 0 0 0 0 0 0 0 0 0 0 - c
x - 0 2 1 0 0 0 0 0 0 0 0 0 0 0 0 0 0 0 0 0 0 0 0 0 0 0 2 1 0 - x
c - 0 1 1 0 0 0 0 0 0 0 0 0 0 0 0 0 0 0 0 0 0 0 0 0 0 0 2 2 0 - c
x - 0 0 0 0 0 0 0 0 0 0 0 0 0 0 0 0 0 0 0 0 0 0 0 0 0 0 0 0 0 - x
c - 0 0 0 0 0 0 0 0 0 0 0 0 0 0 0 0 0 0 0 0 0 0 0 0 0 0 0 0 0 - c
x - 0 0 0 0 0 0 0 0 0 0 0 0 0 0 0 0 0 0 0 0 0 0 0 0 0 0 0 0 0 - x
c - 0 0 0 0 0 0 0 0 0 0 0 0 0 0 0 0 0 0 0 0 0 0 0 0 0 0 0 0 0 - c
x - 0 0 0 0 0 0 0 0 0 0 0 0 0 0 0 0 0 0 0 0 0 0 0 0 0 0 0 0 0 - x
c - 0 0 0 0 0 0 0 0 0 0 0 0 0 0 0 0 0 0 0 0 0 0 0 0 0 0 0 0 0 - c
x - 0 0 0 0 0 0 0 0 0 0 0 0 0 0 x 0 0 0 0 0 0 0 0 0 0 0 0 0 0 - x
c - 0 0 0 0 0 0 0 0 0 0 0 0 0 0 x 0 0 0 0 0 0 0 0 0 0 0 0 0 0 - c
x - 0 x 0 0 0 0 b 0 0 0 0 0 0 0 x 0 0 0 0 0 0 0 b 0 0 0 0 x 0 - x
c - 0 0 x 0 0 x 0 0 0 0 0 0 0 1 2 1 0 0 0 0 0 0 0 x 0 0 x 0 0 - c
x - 0 0 0 1 1 0 0 0 0 0 0 x x 2 b 2 x x 0 0 0 0 0 0 2 2 0 0 0 - x
c - 0 0 x 0 0 x 0 0 0 0 0 0 0 1 2 1 0 0 0 0 0 0 0 x 0 0 x 0 0 - c
x - 0 x 0 0 0 0 b b 0 0 0 0 0 0 x 0 0 0 0 0 0 0 b 0 0 0 0 x 0 - x
c - 0 0 0 0 0 0 0 0 0 0 0 0 0 0 x 0 0 0 0 0 0 0 0 0 0 0 0 0 0 - c
x - 0 0 0 0 0 0 0 0 0 0 0 0 0 0 x 0 0 0 0 0 0 0 0 0 0 0 0 0 0 - x
c - 0 0 0 0 0 0 0 0 0 0 0 0 0 0 0 0 0 0 0 0 0 0 0 0 0 0 0 0 0 - c
x - 0 0 0 0 0 0 0 0 0 0 0 0 0 0 0 0 0 0 0 0 0 0 0 0 0 0 0 0 0 - x
c - 0 0 0 0 0 0 0 0 0 0 0 0 0 0 0 0 0 0 0 0 0 0 0 0 0 0 0 0 0 - c
x - 0 0 0 0 0 0 0 0 0 0 0 0 0 0 0 0 0 0 0 0 0 0 0 0 0 0 0 0 0 - x
c - 0 0 0 0 0 0 0 0 0 0 0 0 0 0 0 0 0 0 0 0 0 0 0 0 0 0 0 0 0 - c
x - 0 0 b 0 0 0 0 0 0 0 0 0 0 0 0 0 0 0 0 0 0 0 0 0 0 0 0 x 0 - x
c - 0 0 x 0 0 0 0 0 0 0 0 0 0 0 0 0 0 0 0 0 0 0 0 0 0 0 0 x 0 - c
x - 0 0 x 0 0 x 0 0 0 0 0 0 0 0 0 0 0 0 0 0 0 0 0 0 x 0 0 x 0 - x
c - 0 1 2 x x 0 0 0 0 0 0 0 0 0 0 0 0 0 0 0 0 0 0 0 0 x x 1 2 - c
x - 0 2 1 0 0 x 0 0 0 0 0 0 0 0 0 0 0 0 0 0 0 0 0 0 x 0 0 2 1 - x
c - 0 0 0 0 0 0 0 0 0 0 0 0 0 0 0 0 0 0 0 0 0 0 0 0 0 0 0 0 0 - c
x - - - - - - - - - - - - - - - - - - - - - - - - - - - - - - - x
c x c x c x c x c x c x c x c x c x c x c x c x c x c x c x c x c
