2
0
0 0
8 8
c c c c c c c c
c c c c c c c c
c c c c c c c c
c c c 1 2 c c c
c c c 2 1 c c c
c c c c c c c c
c c c c c c c c
c c c c c c c c