2
3
0 0
26 23
0 0 0 0 0 0 0 0 0 0 0 0 0 0 0 0 0 0 0 0 0 0 0 
0 0 0 0 0 0 0 - - - - 0 0 0 0 0 0 0 0 0 0 0 0 
0 0 0 0 0 - - 0 0 0 0 - - 0 0 0 0 0 0 0 0 0 0 
0 0 0 0 - 0 0 0 0 0 0 0 0 - 0 0 0 0 0 0 0 0 0 
0 0 0 0 - 0 0 0 0 0 0 0 0 0 - 0 0 0 0 0 0 0 0 
0 0 0 - 0 0 0 0 0 0 0 - 0 0 0 - 0 0 0 0 0 0 0 
0 0 0 - 0 1 2 0 0 0 0 - 0 0 0 - 0 0 0 0 0 0 0 
0 0 0 - 0 2 1 0 0 0 - 0 0 0 0 - 0 0 0 0 0 0 0 
0 0 - 0 0 0 0 0 0 0 - 0 0 0 - 0 0 0 0 0 0 0 0 
0 - - 0 0 0 0 0 0 - 0 0 0 0 - 0 0 0 0 0 0 0 0 
0 - - 0 0 0 0 0 0 - 0 0 0 - - 0 0 0 0 0 0 0 0 
0 - 0 0 0 0 0 0 0 - 0 0 0 - 0 - 0 0 0 0 0 0 0 
0 0 - 0 0 0 0 - 0 0 - - - 0 0 - 0 0 0 0 0 0 0 
0 0 0 - - - - 0 - 0 0 0 0 0 0 0 - - 0 0 0 0 0 
0 0 0 0 0 0 0 0 - 0 0 0 0 0 0 0 0 0 - 0 0 0 0 
0 0 0 0 0 0 0 - 0 0 0 0 0 0 0 0 0 0 0 - 0 0 0 
0 0 0 0 0 0 0 - 0 0 0 0 0 0 0 0 0 0 0 - 0 0 0 
0 0 0 0 0 0 0 - 0 0 0 0 0 0 0 0 0 0 0 0 - 0 0 
0 0 0 0 0 0 0 - 0 0 0 0 0 0 0 0 0 0 0 0 - 0 0 
0 0 0 0 0 0 0 0 - 0 0 0 0 0 0 0 0 0 0 0 0 - 0 
0 0 0 0 0 0 0 0 - 0 0 0 - 0 0 0 0 0 0 0 0 - 0 
0 0 0 0 0 0 0 0 - 0 0 0 - - 0 0 0 0 - 0 0 - 0 
0 0 0 0 0 0 0 - 0 0 0 - - 0 - - - - 0 0 0 - 0 
0 0 0 0 0 0 - i 0 0 - 0 0 - 0 0 0 0 0 0 - 0 0 
0 0 0 0 0 0 - - - - 0 - - - - - - - - - 0 0 0 
0 0 0 0 0 0 0 0 0 0 0 0 0 0 0 0 0 0 0 0 0 0 0 
2 11 6 <-> 14 23 6
19 23 2 <-> 19 23 4
9 7 2 <-> 11 7 6
10 6 2 <-> 12 6 6
10 5 2 <-> 12 5 6
8 9 2 <-> 10 9 6
8 10 2 <-> 10 10 6
8 11 2 <-> 10 11 6
10 11 4 <-> 10 13 0
11 11 4 <-> 11 13 0
12 11 4 <-> 12 13 0
11 23 6 <-> 9 23 2
12 23 5 <-> 19 17 0
