2
4
0 0
21 23
0 0 0 0 0 0 0 0 0 0 0 - - - - - 0 0 0 0 0 0 0
0 0 0 0 0 0 0 0 - - - 0 0 0 0 0 - - - 0 0 0 0
0 0 0 0 0 0 - - 0 0 0 0 0 0 0 0 0 0 0 - 0 0 0
0 0 0 0 0 - 0 0 0 0 0 0 0 0 0 0 0 0 0 0 - 0 0
0 0 0 0 - 0 0 0 0 0 0 0 0 0 0 0 0 0 0 0 i - 0
0 0 0 - 0 0 0 0 0 0 0 0 0 0 0 0 0 0 0 0 i - 0
0 0 - 0 0 0 0 0 0 0 0 0 i - 0 0 0 0 0 0 i i -
0 0 - 0 0 0 0 0 0 0 i i i - 0 0 0 0 0 0 i i -
0 - 0 0 0 0 0 0 0 1 2 i i - 0 0 0 0 0 i i i -
0 - 0 0 0 0 0 0 i 2 1 i - 0 0 0 0 0 0 i i i -
- 0 0 0 0 0 0 0 i i i i - 0 0 0 0 0 i i i i -
- 0 0 0 0 0 0 i i i - - 0 0 0 0 0 0 i i i - 0
- 0 0 0 0 0 0 - - - 0 0 0 0 0 0 0 i i i i - 0
- 0 0 0 0 0 0 0 0 0 0 0 0 0 0 0 i i i i - 0 0
- 0 0 0 0 0 0 0 0 0 0 0 0 0 0 i i i i i - 0 0
0 - 0 0 0 0 0 0 0 0 0 0 0 i i i i i i - 0 0 0
0 - 0 0 0 0 0 0 0 0 0 i i i i i i i - 0 0 0 0
0 0 - 0 0 0 0 0 i i i i i i i i i - 0 0 0 0 0
0 0 0 - i i i i i i i i i i i - - 0 0 0 0 0 0
0 0 0 0 - - - i i i i i - - - 0 0 0 0 0 0 0 0
0 0 0 0 0 0 0 - - - - - 0 0 0 0 0 0 0 0 0 0 0