2
0
0 0
8 8
i i i i i i i i
i i i i i i i i
i i i i i i i i
i i i 1 2 i i i
i i i 2 1 i i i
i i i i i i i i
i i i i i i i i
i i i i i i i i