2
4
0 0
25 25
- - - - - - - 0 - 0 - 0 - 0 - 0 - 0 - - - - - - - 
- 0 0 0 0 0 - 0 0 - - - - - 0 - 0 0 - 0 0 0 0 0 - 
- 0 - - - 0 - 0 - - - 0 0 0 0 - 0 0 - 0 - - - 0 - 
- 0 - - - 0 - 0 - - - 0 - - - - - 0 - 0 - - - 0 - 
- 0 - - - 0 - 0 - 0 0 - - 0 0 - 0 0 - 0 - - - 0 - 
- 0 0 0 0 0 - 0 0 0 - - 0 0 - - - 0 - 0 0 0 0 0 - 
- - - - - - - 0 - 0 - 0 - 0 - 0 - 0 - - - - - - - 
0 0 0 0 0 0 0 0 0 0 - 0 - 0 - - - 0 0 0 0 0 0 0 0 
- - - - 0 0 - 0 - 0 - - 0 0 0 0 0 - 0 0 - - - 0 - 
0 - 0 - - - 0 0 0 0 - 0 - 0 - 0 0 - 0 - - 0 0 0 - 
- 1 2 0 0 - - - 0 - - - 0 - 0 0 - 0 0 0 0 - - - - 
0 2 1 0 - - 0 0 0 - - 0 1 2 0 - 0 0 - - 0 - - 0 - 
- 0 0 - 0 0 - - 0 - - 0 2 1 0 - - - 0 - - - 0 - - 
0 0 - - 0 - 0 0 - 0 0 0 - 0 - 0 - 0 0 - 0 - 0 0 0 
0 - 0 0 0 0 - 0 0 0 - - 0 0 - 0 0 - 0 - - - 0 0 - 
- 0 - - 0 0 0 0 - - - - - 0 0 0 - 0 0 0 0 0 0 - - 
0 0 - 0 0 - - - 0 0 - - - 0 0 0 - - - - - 0 0 - 0 
0 0 0 0 0 0 0 0 - - 0 0 - - - - - 0 0 0 - - - 0 0 
- - - - - - - 0 0 0 - - - - 0 0 - 0 - 0 - 0 - - - 
- 0 0 0 0 x - 1 2 - - 0 - - - 0 - 0 0 0 - 0 0 - -
- 0 - - - 0 - 2 1 0 0 0 - 0 - - - - - - - 0 - 0 - 
- 0 - - - 0 - 0 - 0 - - 0 0 0 - - 0 - 0 - 0 0 - - 
- 0 - - - 0 - 0 - - 0 0 0 - 0 - 0 0 0 0 0 - - - 0 
- 0 0 0 0 0 - 0 - 0 0 - - - 0 0 0 - 0 0 - 0 - - - 
- - - - - - - 0 - 0 0 0 0 - 0 - 0 - 0 0 0 0 - - - 
7 0 0 <-> 7 24 4
0 7 6 <-> 24 7 2
1 1 0 <-> 1 1 6
5 1 0 <-> 5 1 2
1 5 4 <-> 1 5 6
5 5 4 <-> 4 12 0
4 17 4 <-> 5 19 0
1 19 0 <-> 1 19 6
1 23 4 <-> 1 23 6
5 23 2 <-> 5 23 4
17 21 0 <-> 17 19 4
19 21 0 <-> 19 19 4
20 13 2 <-> 22 13 6
20 13 4 <-> 20 15 0
20 13 6 <-> 18 13 2
20 13 0 <-> 20 11 4
7 17 2 <-> 7 17 0
17 22 4 <-> 18 24 6
21 24 2 <-> 19 24 4
19 17 2 <-> 19 17 0
17 17 6 <-> 17 17 0
16 24 4 <-> 17 22 7
