2
4
0 0
22 22
0 0 0 0 0 0 0 0 0 0 0 0 0 0 0 0 0 0 0 0 0 0
0 0 0 0 0 0 0 0 0 0 0 0 0 0 0 0 0 0 0 0 0 0
0 0 0 0 0 0 0 0 0 - - - - 0 0 0 0 0 0 0 0 0
0 0 0 0 0 0 0 0 - 0 0 0 0 - 0 0 0 0 0 0 0 0
0 0 0 0 0 0 0 - 0 0 0 0 0 0 - 0 0 0 0 0 0 0
0 0 0 0 0 0 - 0 0 0 0 0 0 0 0 - 0 0 0 0 0 0
0 0 0 0 0 0 - 0 0 0 1 2 0 0 0 - 0 0 0 0 0 0
0 0 0 0 0 0 - 0 0 0 2 1 0 0 0 - 0 0 0 0 0 0
0 0 0 0 0 0 - 0 0 0 0 0 0 0 0 - 0 0 0 0 0 0
0 0 0 0 - - - 0 0 0 0 0 0 0 0 - - - 0 0 0 0
0 0 0 0 - 0 0 0 0 0 0 0 0 0 0 0 0 - 0 0 0 0
0 0 0 0 0 0 - 0 0 0 0 0 0 0 0 - 0 0 0 0 0 0
0 0 0 0 0 0 - 0 0 0 0 0 0 0 0 - 0 0 0 0 0 0
0 0 0 0 0 - 0 0 0 0 0 0 0 0 0 0 - 0 0 0 0 0
0 0 0 0 - 0 0 0 0 0 0 0 0 0 0 0 0 - 0 0 0 0
0 0 0 - 0 0 0 0 0 0 0 0 0 0 0 0 0 0 - 0 0 0
0 0 0 - - 0 0 0 0 0 0 0 0 0 0 0 0 - - 0 0 0
0 0 0 0 - - - - 0 0 0 0 0 0 - - - - 0 0 0 0
0 0 0 0 0 0 0 0 - - 0 0 - - 0 0 0 0 0 0 0 0
0 0 0 0 0 0 0 0 0 0 - - 0 0 0 0 0 0 0 0 0 0
0 0 0 0 0 0 0 0 0 0 0 0 0 0 0 0 0 0 0 0 0 0
0 0 0 0 0 0 0 0 0 0 0 0 0 0 0 0 0 0 0 0 0 0