2
4
0 0
31 26
0 0 0 0 0 0 0 0 0 0 0 0 0 0 0 0 0 0 0 0 0 0 0 0 0 0
0 0 0 0 0 0 0 0 0 0 0 - 0 - 0 0 0 0 0 0 0 0 0 0 0 0
0 0 0 0 0 0 0 0 0 - 0 0 - 0 - 0 - 0 - 0 0 0 0 0 0 0
0 0 0 0 0 - 0 0 - 0 0 - 0 - 0 0 - - 0 0 0 0 0 0 0 0
0 0 0 0 0 0 - 0 - 0 - 0 0 - - 0 - 0 0 - 0 - 0 0 0 0
0 0 0 0 - 0 - - 0 0 - 0 0 - 0 0 0 - - 0 - 0 0 0 0 0
0 0 0 - - 0 0 0 - 0 0 - 0 - 0 - - 0 0 - 0 0 - 0 0 0
0 0 - 0 0 - - 0 0 - 0 0 - 0 - 0 0 0 - 0 - - 0 0 0 0
0 0 0 0 - 0 0 - 0 0 - 0 - - - 0 0 0 - 0 0 0 - 0 0 0
0 0 0 0 0 - 0 - 0 0 - 0 - 0 0 - - - 0 0 - - 0 0 0 0
0 - 0 - 0 0 0 0 - - - - - 0 - 0 0 0 0 0 0 0 - 0 0 0
0 0 - 0 0 - - - 0 0 0 - - - 0 - - 0 0 0 0 0 - - 0 0
0 0 0 - - 0 0 0 - - 0 - - - 0 0 - - 0 0 - - 0 0 0 0
0 0 0 0 0 0 0 - 0 - 0 - - - 0 0 - 0 0 - 0 0 - 0 0 0
0 0 - - 0 - 0 - 0 0 0 - - - - - - 0 0 - - 0 0 0 0 0
0 0 0 0 - 0 0 0 - 0 0 - - - - 0 0 - - 0 0 - 0 0 - 0
0 0 0 - 0 - - - - 0 0 - - - 0 0 0 - 0 0 - 0 - - 0 0
0 0 0 0 0 0 0 0 - - - - - - - - - - - 0 0 0 0 0 0 0
0 0 - - 0 - - 0 - - - - - - - - 0 0 0 0 0 0 0 - 0 0
0 0 0 0 - 0 0 0 0 0 - - - - 0 0 - - - - - 0 - 0 0 0
0 0 0 0 - - 0 - - - - - - - - - - - 0 0 - - 0 0 0 0
0 0 0 0 0 - - - - - - - - - - - 0 0 0 0 0 0 - 0 0 0
0 0 0 0 0 0 0 0 0 0 - - - - 0 0 0 0 0 0 0 0 0 0 0 0
0 0 0 0 0 0 0 0 0 0 - - - - 0 0 0 0 0 0 0 0 0 0 0 0
0 0 0 0 0 0 0 0 0 0 - - - - 0 0 0 0 0 0 0 0 0 0 0 0
0 0 0 0 0 0 0 0 0 0 - - - - 0 0 0 0 0 0 0 0 0 0 0 0
0 0 0 0 0 0 0 0 0 0 - - - - 0 0 0 0 0 0 0 0 0 0 0 0
0 0 0 0 0 0 0 0 0 0 - - - - 0 0 0 0 0 0 0 0 0 0 0 0
0 0 0 0 2 1 0 0 0 - - - - - - 0 0 1 2 0 0 0 0 0 0 0
0 0 0 0 1 2 0 0 - - - - - - - - 0 2 1 0 0 0 0 0 0 0
- - - - - - - - - - - - - - - - - - - - - - - - - -