5
7
1 1
8 10
0 0 0 - - - - 0 0 0
0 i 0 0 0 0 x 0 0 0
- 0 1 4 5 0 0 b b -
- 0 5 1 4 0 0 0 0 -
- 0 4 5 1 0 3 2 0 -
- 0 0 0 x x 2 3 c -
0 c 0 0 0 0 0 0 0 0
0 0 - - - - - - 0 0

0 0 0 <-> 8 2 2
2 6 4 <-> 8 6 5
5 1 0 <-> 5 6 3