5
0
1 2
43 29
c c c c c - - - - - - - - - - - - - - - - - - c c - - - -
c c - - c c - - - - - - - - - - - - - - - - - c c - - - -
c c - - c c - - c c c c - - c c c c c c - - - c c c c c -
c c c c c - - c c - - c c - c c c c c c c c - c c - - c c
c c - - c c - c c - - c c - c c - c c - c c - c c - - c c
c c - - c c - c c - - c c - c c - c c - c c - c c - - c c
c c c c c - - - c c c c - - c c - c c - c c - c c c c c -
- - - - - - - - - - - - - - - - - - - - - - - - - - - - -
0 0 0 0 0 - 0 0 0 0 0 - 0 0 0 0 0 - 0 0 0 0 0 - 0 0 0 0 0
0 1 b 1 0 - 0 0 x 0 0 - 0 2 b 2 0 - 0 0 x 0 0 - 0 3 b 3 0
0 1 x 1 0 - 0 x x x 0 - 0 2 x 2 0 - 0 x x x 0 - 0 3 x 3 0
0 1 1 1 0 - 0 0 x 0 0 - 0 2 2 2 0 - 0 0 x 0 0 - 0 3 3 3 0
0 0 0 0 0 - 0 0 0 0 0 - 0 0 0 0 0 - 0 0 0 0 0 - 0 0 0 0 0
- - - - - - - - - - - - - - - - - - - - - - - - - - - - -
0 0 0 0 0 - 0 0 0 0 0 - 0 0 0 0 0 - 0 0 0 0 0 - 0 0 0 0 0
0 0 x 0 0 - 0 4 b 4 0 - 0 0 x 0 0 - 0 5 b 5 0 - 0 0 x 0 0
0 x x x 0 - 0 4 x 4 0 - 0 x x x 0 - 0 5 x 5 0 - 0 x x x 0
0 0 x 0 0 - 0 4 4 4 0 - 0 0 x 0 0 - 0 5 5 5 0 - 0 0 x 0 0
0 0 0 0 0 - 0 0 0 0 0 - 0 0 0 0 0 - 0 0 0 0 0 - 0 0 0 0 0
- - - - - - - - - - - - - - - - - - - - - - - - - - - - -
0 0 0 0 0 - 0 0 0 0 0 - 0 0 0 0 0 - 0 0 0 0 0 - 0 0 0 0 0
0 1 b 1 0 - 0 0 x 0 0 - 0 2 b 2 0 - 0 0 x 0 0 - 0 3 b 3 0
0 1 x 1 0 - 0 x x x 0 - 0 2 x 2 0 - 0 x x x 0 - 0 3 x 3 0
0 1 1 1 0 - 0 0 x 0 0 - 0 2 2 2 0 - 0 0 x 0 0 - 0 3 3 3 0
0 0 0 0 0 - 0 0 0 0 0 - 0 0 0 0 0 - 0 0 0 0 0 - 0 0 0 0 0
- - - - - - - - - - - - - - - - - - - - - - - - - - - - -
0 0 0 0 0 - 0 0 0 0 0 - 0 0 0 0 0 - 0 0 0 0 0 - 0 0 0 0 0
0 0 x 0 0 - 0 4 b 4 0 - 0 0 x 0 0 - 0 5 b 5 0 - 0 0 x 0 0
0 x x x 0 - 0 4 x 4 0 - 0 x x x 0 - 0 5 x 5 0 - 0 x x x 0
0 0 x 0 0 - 0 4 4 4 0 - 0 0 x 0 0 - 0 5 5 5 0 - 0 0 x 0 0
0 0 0 0 0 - 0 0 0 0 0 - 0 0 0 0 0 - 0 0 0 0 0 - 0 0 0 0 0
- - - - - - - - - - - - - - - - - - - - - - - - - - - - -
0 0 0 0 0 - 0 0 0 0 0 - 0 0 0 0 0 - 0 0 0 0 0 - 0 0 0 0 0
0 1 b 1 0 - 0 0 x 0 0 - 0 2 b 2 0 - 0 0 x 0 0 - 0 3 b 3 0
0 1 x 1 0 - 0 x x x 0 - 0 2 x 2 0 - 0 x x x 0 - 0 3 x 3 0
0 1 1 1 0 - 0 0 x 0 0 - 0 2 2 2 0 - 0 0 x 0 0 - 0 3 3 3 0
0 0 0 0 0 - 0 0 0 0 0 - 0 0 0 0 0 - 0 0 0 0 0 - 0 0 0 0 0
- - - - - - - - - - - - - - - - - - - - - - - - - - - - -
0 0 0 0 0 - 0 0 0 0 0 - 0 0 0 0 0 - 0 0 0 0 0 - 0 0 0 0 0
0 0 x 0 0 - 0 4 b 4 0 - 0 0 x 0 0 - 0 5 b 5 0 - 0 0 x 0 0
0 x x x 0 - 0 4 x 4 0 - 0 x x x 0 - 0 5 x 5 0 - 0 x x x 0
0 0 x 0 0 - 0 4 4 4 0 - 0 0 x 0 0 - 0 5 5 5 0 - 0 0 x 0 0
0 0 0 0 0 - 0 0 0 0 0 - 0 0 0 0 0 - 0 0 0 0 0 - 0 0 0 0 0
