2
0
1 4
11 13
- - - - - - - - - - - - - 
- 0 0 0 0 0 0 0 0 0 0 0 0 
- 0 0 0 0 0 0 0 0 0 0 0 0 
- 0 0 0 0 0 0 0 0 0 0 0 0 
- 1 0 0 0 0 0 0 0 0 0 0 2 
- 0 0 0 0 0 0 0 0 0 0 0 0 
- 0 0 0 0 0 0 0 0 0 0 0 0 
- 0 0 0 0 0 0 0 0 0 0 0 0 
- 0 0 0 0 0 0 0 0 0 0 0 0 
- 0 0 0 0 0 0 0 0 0 0 0 0 
- 0 0 0 0 0 0 0 0 0 0 0 0 
4 1 0 <-> 12 1 0
12 1 2 <-> 12 8 2
