2
0
0 0
7 9
0 0 0 0 0 0 0 1 1
- - - - - - - - -
- - - - - - - - -
- - - - - - - - -
- - - - - - - - -
- - - - - - - - -
0 - 0 0 0 - 0 1 1
0 0 6 <-> 0 6 6
0 6 2 <-> 6 6 6