2
0
0 0
5 9
0 - 0 0 0 - 0 0 0
0 - 0 c 0 - 0 1 2
0 - x 0 0 - 0 2 1
0 - - - - - 0 0 0
0 0 0 0 0 0 0 0 0
0 4 4 <-> 0 4 6