2
0
0 0
5 9
0 - 0 0 0 - 0 0 0
0 - 0 c 0 - 0 0 0
0 - 0 0 0 - 0 0 0
0 - - - - - 0 0 0
0 0 0 0 0 1 1 1 1
3 0 0 <-> 8 0 0