2
0
0 0
5 9
0 0 0 0 0 - - - 0
0 0 0 0 1 - - 1 0
0 0 0 0 0 0 0 0 0
0 0 0 0 0 - 0 0 0
0 0 0 0 0 - - 0 0
4 1 2 <-> 7 1 6