2
0
0 0
5 9
0 0 0 0 0 - - - -
0 0 0 0 0 - - x x
0 0 0 0 0 0 0 x x
0 0 0 0 0 - - x -
0 0 0 0 0 - - - -