2
0
5 2
23 23
- - - - - - - - - - - - - - - - - - - - - - - 
- c i i b x 0 0 0 0 x 0 0 x 0 0 0 0 x b i i c 
- i i b x 0 0 0 0 x 0 0 0 0 x 0 0 0 0 x b i i 
- i b x 0 0 0 0 x 0 0 0 0 0 0 x 0 0 0 0 x b i 
- b x 0 0 0 0 x 0 0 0 0 0 0 0 0 x 0 0 0 0 x b 
- x 0 0 0 0 x 0 0 0 0 x x 0 0 0 0 x 0 0 0 0 x 
- 0 0 0 0 x 0 0 0 0 x 0 0 x 0 0 0 0 x 0 0 0 0 
- 0 0 0 x 0 0 0 0 x 0 0 0 0 x 0 0 0 0 x 0 0 0 
- 0 0 x 0 0 0 0 x 0 0 0 0 0 0 x 0 0 0 0 x 0 0 
- 0 x 0 0 0 0 x 0 0 0 0 0 0 0 0 x 0 0 0 0 x 0 
- x 0 0 0 0 x 0 0 0 0 x x 0 0 0 0 x 0 0 0 0 x 
- 0 0 0 0 x 0 0 0 0 x 1 2 x 0 0 0 0 x 0 0 0 0 
- 0 0 0 0 x 0 0 0 0 x 2 1 x 0 0 0 0 x 0 0 0 0 
- x 0 0 0 0 x 0 0 0 0 x x 0 0 0 0 x 0 0 0 0 x 
- 0 x 0 0 0 0 x 0 0 0 0 0 0 0 0 x 0 0 0 0 x 0 
- 0 0 x 0 0 0 0 x 0 0 0 0 0 0 x 0 0 0 0 x 0 0 
- 0 0 0 x 0 0 0 0 x 0 0 0 0 x 0 0 0 0 x 0 0 0 
- 0 0 0 0 x 0 0 0 0 x 0 0 x 0 0 0 0 x 0 0 0 0 
- x 0 0 0 0 x 0 0 0 0 x x 0 0 0 0 x 0 0 0 0 x 
- b x 0 0 0 0 x 0 0 0 0 0 0 0 0 x 0 0 0 0 x b 
- i b x 0 0 0 0 x 0 0 0 0 0 0 x 0 0 0 0 x b i 
- i i b x 0 0 0 0 x 0 0 0 0 x 0 0 0 0 x b i i 
- c i i b x 0 0 0 0 x 0 0 x 0 0 0 0 x b i i c 
5 1 0 <-> 18 1 0
6 1 0 <-> 17 1 0
7 1 0 <-> 16 1 0
8 1 0 <-> 15 1 0
9 1 0 <-> 14 1 0
10 1 0 <-> 13 1 0
11 1 0 <-> 12 1 0
11 22 4 <-> 12 22 4
10 22 4 <-> 13 22 4
9 22 4 <-> 14 22 4
8 22 4 <-> 15 22 4
7 22 4 <-> 16 22 4
6 22 4 <-> 17 22 4
5 22 4 <-> 18 22 4
1 5 6 <-> 1 18 6
1 6 6 <-> 1 17 6
1 7 6 <-> 1 16 6
1 8 6 <-> 1 15 6
1 9 6 <-> 1 14 6
1 10 6 <-> 1 13 6
1 11 6 <-> 1 12 6
22 11 2 <-> 22 12 2
22 10 2 <-> 22 13 2
22 9 2 <-> 22 14 2
22 8 2 <-> 22 15 2
22 7 2 <-> 22 16 2
22 6 2 <-> 22 17 2
22 5 2 <-> 22 18 2
