2
2
0 1
9 15
- - - - - - - - - - - - - - -
- - - - - - - - 0 0 0 0 0 - -
- 0 x x x 0 - 1 2 0 0 0 0 0 -
- x x 0 x x - 2 1 0 0 0 0 0 -
- x 0 b 0 x - 0 0 0 i 0 0 0 -
- x x 0 x x - 0 0 0 0 0 2 1 -
- 0 x x x 0 - 0 0 0 0 0 1 2 -
- - - - - - - - 0 0 0 0 0 - -
- - - - - - - - - - - - - - -