3
10
2 6
50 50
- - - - - - - - - - - - - - - - - - - - - - - - - - - - - - - - - - - - - - - - - - 0 0 0 0 0 - - -
- - - - - - - - - - - - - - - - - - - - - - - - - - - - - - - - - - - - - - - - - 0 0 0 b 0 0 0 - -
- - - - - - - - - - - - - - - - - - - - - - - - - - - - - - - - - - - - - - 0 0 0 0 0 0 0 0 0 0 0 0
- - - - - - - - - - - - - - - - - - - - - - - - - - - - - - - - - - - - - 0 0 0 0 0 0 0 0 0 0 0 0 0
- - - - - - - - - - - - - - - - - - - - - - - - - - - - - - - - - - - - 0 0 0 0 0 0 0 0 0 0 0 0 0 0
- - - - - - - - - - - - - - - - - - - - - - - - - - - - - - - - - - - 0 0 0 0 0 0 0 0 0 0 i 0 0 0 0
- - - - - - - - - - - - - - - - - - - - - - - - - - - - - - - - - - - 0 0 0 0 0 0 0 0 0 0 0 0 0 0 0
- - - - - - - - - - - - - - - - - - - - - - - - - - - - - - - - - - - 0 0 0 0 0 0 0 0 0 0 0 0 0 b 0
- - - - - - - - - - - - - - - - - - - - - - - - - - - - - - - - - - 0 0 0 0 0 x 0 0 0 0 0 0 0 0 0 0
- - - - - - - - - - - - - - - - - - - - - - - - - - - - - - - - - 0 0 0 0 0 x x x 0 0 0 0 0 0 0 0 0
- - - - - - - - - - - - - - - - - - - - - - - - - - - - - - - - 0 0 0 0 0 0 0 x 0 0 0 0 0 0 0 - - -
- - - - - - - - - - - - - - - - - - - - - - - - - - - - - - 0 0 0 0 0 0 0 0 0 0 0 0 0 0 0 0 - - - -
- - - - - - - - - - - - - - - - - - - - - - - - - - - - - 0 0 0 0 0 0 0 0 0 0 0 0 0 0 0 0 - - - - -
- - - - - - - - - - - - - - - - - - - - - - - - - - - - 0 0 0 b 0 0 0 0 0 0 0 0 0 0 0 0 - - - - - -
- - - - - - - - - - - - - - - - - - - - - - - - - - 0 0 0 0 0 0 0 0 0 0 0 0 0 0 0 0 0 - - - - - - -
- - - - - - - - - - - - - - - - - - - - - - - - - - 0 0 0 0 0 0 0 0 0 0 0 0 0 0 0 0 0 0 - - - - - -
- - - - - - - - - - - - - - - - - - - - - - - - - - 0 0 0 0 0 0 0 0 0 0 0 0 0 0 0 0 0 0 - - - - - -
- - - - - - - - 0 0 - 0 0 0 0 - - - - - - - - - - - - 0 0 0 0 0 - 0 0 0 0 b 0 0 0 0 - - - - - - - -
- - - - - - - - - 0 0 0 0 0 0 0 0 - - - - - - - - - - 0 0 0 - - - - 0 0 0 0 0 0 - - - - - - - - - -
- - - - - - - - - - 0 0 b 0 0 0 - - - - - - - - - - - - - - - - 0 - - 0 0 0 0 0 - - - - - - - - 0 0
- - - - - - - - - - - 0 0 0 0 - - - - - - - - - - - - - - - 0 0 0 0 - - 0 0 0 0 0 - - - - - 0 - - 0
- - - - 0 0 0 0 - - - 0 0 0 0 0 0 - - - - - - - - - - - - - 0 0 c 0 - - 0 0 0 0 - - - - - - 0 - - 0
- - - 0 0 x 0 b 0 0 - - - 0 0 0 x 0 - - - - - - - - - - - - - 0 0 - - - 0 0 - - - - - - - 0 0 0 0 0
- - 0 0 x x x 0 0 - - - - - 0 0 x 0 0 - - - - - - - - - - - - - 0 0 - - 0 - - - - - - - - 0 0 0 0 0
- - - 0 0 x 0 0 0 - - 0 0 0 0 i x 0 0 0 - - - - - - - - - - 0 - 0 - - - - - - 0 0 0 - 0 0 0 0 0 0 0
- 0 0 0 c 0 0 0 0 - - 0 0 0 0 0 0 b 0 0 0 - - - - - - 0 0 0 0 0 0 0 0 0 0 0 0 0 0 0 0 0 0 0 0 0 0 0
- - 0 0 0 0 - - - - - 0 0 0 0 0 0 0 0 0 - - - - - - 0 0 0 0 0 0 0 0 0 0 0 0 0 0 0 0 0 0 0 0 0 0 0 0
- - - - - - - - - - - 0 0 0 0 0 0 0 0 - - - - - - 0 0 0 0 0 0 0 0 0 0 b 0 0 0 0 0 0 0 0 0 0 b 0 0 0
- - - - - - - - - - 0 0 0 0 0 - - - - - 0 0 0 0 0 0 0 0 0 0 0 0 0 0 0 0 0 0 0 0 0 i 0 0 0 0 0 0 0 0
- - - - - - - - - - - - - - - - 0 0 0 0 0 0 0 0 0 0 0 0 0 0 0 0 0 0 0 0 0 0 0 0 0 0 0 0 0 0 0 0 0 0
- - - - - - - - - - - - 0 0 0 0 0 0 0 0 0 0 0 0 0 0 0 0 0 0 0 0 0 0 0 0 0 0 0 0 0 0 0 0 0 0 0 0 0 0
- - - - - - - - - - - - 0 0 0 0 0 0 b 0 0 0 0 0 0 0 0 0 0 0 0 0 0 0 0 0 0 0 0 0 0 0 0 0 0 0 0 0 0 0
- - - - - - - - - - - - - - - 0 0 0 0 0 0 0 0 0 0 0 0 0 0 0 0 0 0 0 3 2 1 0 0 0 0 0 0 0 0 0 0 0 0 0
- - - - - - - - - - - - - - - - 0 0 0 0 0 0 0 0 0 i 0 0 0 0 0 0 0 0 1 3 2 0 0 0 0 0 b 0 0 0 0 0 0 0
- - - - - - - - - - - - - - - - - 0 0 0 0 0 0 0 0 0 0 0 0 0 0 0 0 0 2 1 3 0 0 0 0 0 0 0 0 0 0 0 0 0
- - - - - - - - - - - - - - - - 0 0 0 0 0 0 0 0 0 0 0 0 0 0 0 0 0 0 0 0 0 0 0 - 0 0 0 0 0 0 0 0 0 b
- - - - - - - - - - - - - - - - 0 0 0 0 0 0 0 0 0 0 0 0 0 0 0 0 0 0 0 0 0 0 0 - - 0 0 0 0 0 0 0 0 0
- - - - - - - - - - - - - - - 0 0 0 0 0 0 0 0 0 0 0 0 0 0 0 0 0 0 0 0 0 0 0 0 - - - 0 0 0 0 0 0 0 0
- - - - - - - 0 0 0 - - - - 0 0 0 0 0 0 0 0 0 0 0 0 0 0 0 0 0 - - - 0 0 0 0 0 0 - - - 0 0 0 0 0 0 0
- - - 0 0 0 0 0 0 0 0 0 0 0 0 0 0 0 0 0 0 0 - - - 0 0 0 - - - - - - - 0 0 0 0 0 0 - - - 0 0 0 0 0 0
- - - - 0 0 0 0 0 0 0 0 0 0 0 b 0 0 0 0 0 0 - - - - - - - - - 0 0 - - - 0 0 b 0 0 0 - - - - - 0 0 0
- - - - 0 0 0 0 i 0 0 0 0 0 0 0 0 0 0 0 0 0 - - - - - - - - - - 0 - - - - - 0 0 0 0 0 0 - - - - - -
- - - - 0 0 0 0 0 0 x 0 0 0 0 0 0 0 0 0 - - - - - - - - - - 0 c x - - - - - - - - 0 0 0 0 0 0 - - -
- - - - 0 0 0 0 0 x x x 0 0 0 0 0 0 0 - - - - - - - - - - - - 0 0 - - - - - - - - - - 0 0 0 0 0 0 -
- - - 0 0 0 0 0 0 b x 0 0 0 0 0 0 0 - - - - - - - - - - - - - 0 b - - - - - - - - - - - - 0 0 - - -
- - 0 0 0 0 0 0 0 0 0 0 0 0 0 0 0 0 0 - - - - - - - - - - - - 0 0 - - - - - - - - - - - - 0 0 0 - -
- - - - 0 0 0 0 0 b 0 0 0 0 0 0 0 0 0 - - - - - - - - - - - - - - - - - - - - - - 0 0 0 0 0 0 - - -
- - - - 0 0 0 0 0 0 0 0 0 0 0 0 0 0 - - - - - - - - - - - - - - - - - - - - - - - 0 0 c 0 - - - - -
- - - - - - - - 0 0 0 0 0 0 0 0 0 - - - - - - - - - - - - - - - - - - - - - - - - - - 0 x - - - - -
- - - - - - - - - 0 - - - - - - - - - - - - - - - - - - - - - - - - - - - - - - - - - - - - - - - -
27 25 6 <-> 19 24 2
27 25 1 <-> 29 18 5
18 45 2 <-> 30 42 6
18 45 3 <-> 42 46 7
