4
6
3 2
15 47
- - - - 0 0 0 0 0 0 0 - - - - - 0 0 0 0 0 0 0 0 0 0 0 0 0 0 0 - 0 0 0 0 0 - - - - - i 0 0 0 0 
- - - 0 0 0 0 0 0 0 i 0 - - - - 0 0 0 0 0 0 0 0 0 0 0 0 0 0 0 - 0 i 0 0 0 - - - - - 0 0 x 0 0
- - 0 0 0 0 0 0 0 0 0 0 0 - - - 0 0 0 0 0 0 0 0 0 0 0 0 0 0 0 - 0 0 0 0 0 - - - - - 0 x x x 0
- 0 0 0 0 0 0 b 0 0 0 0 0 0 - - 0 0 0 0 0 0 0 0 0 0 0 0 0 0 0 - 0 0 0 0 0 - - - - - 0 0 x 0 0
0 0 0 0 0 - - - - - 0 0 0 0 0 - - - - - - 0 0 0 0 0 - - - - - - 0 0 0 0 0 - - - - - 0 0 0 0 0
0 0 0 0 - - - - - - - 0 0 0 0 - - - - - - x 0 0 0 x - - - - - - 0 0 0 0 0 0 0 0 0 0 0 0 0 0 0
0 0 0 0 - - - - - - - 0 0 0 0 - - - - - - x 3 3 3 x - - - - - - 0 0 0 0 0 x x 0 x x 0 0 0 0 0
b 0 0 0 - - - - - - - 0 0 0 0 - - - - - - 1 x 3 x 4 - - - - - - c 0 0 0 0 0 x x x 0 0 0 c 0 0
0 0 0 0 - - - - - - - 0 0 0 0 - - - - - - 1 1 x 4 4 - - - - - - 0 0 0 0 0 0 0 x 0 0 0 0 0 0 0
0 0 0 0 - - - - - - - 0 0 0 0 - - - - - - 1 x 2 x 4 - - - - - - 0 0 0 0 0 - - - - - 0 0 0 0 0
0 0 0 0 0 - - - - - 0 0 0 0 0 - - - - - - x 2 2 2 x - - - - - - 0 0 0 0 0 - - - - - 0 0 0 0 0
- 0 0 0 0 0 0 b 0 0 0 0 0 0 - - - - - - - x 0 0 0 x - - - - - - 0 0 0 0 0 - - - - - 0 0 x 0 0
- - 0 0 0 0 0 0 0 0 0 i 0 - - - - - - - - 0 0 0 0 0 - - - - - - 0 0 0 0 0 - - - - - 0 x x x 0
- - - 0 0 0 0 0 0 0 0 0 - - - - - - - - - 0 0 0 0 0 - - - - - - 0 i 0 0 0 - - - - - 0 0 x 0 0
- - - - 0 0 0 0 0 0 0 - - - - - - - - - - 0 0 0 0 0 - - - - - - 0 0 0 0 0 - - - - - i 0 0 0 0
11 0 2 <-> 17 0 6
12 1 2 <-> 17 1 6
13 2 2 <-> 17 2 6
14 3 2 <-> 17 3 6
14 11 2 <-> 22 11 6
13 12 2 <-> 22 12 6
12 13 2 <-> 22 13 6
11 14 2 <-> 22 14 6
31 0 2 <-> 33 0 6
31 1 2 <-> 33 1 6
31 2 2 <-> 33 2 6
31 3 2 <-> 33 3 6
26 11 2 <-> 33 11 6
26 12 2 <-> 33 12 6
26 13 2 <-> 33 13 6
26 14 2 <-> 33 14 6