3
6
4 0
15 15
- - - - - 0 0 0 0 0 - - - - -
- - - - - 0 0 0 0 0 - - - - -
- - - - - 0 0 0 0 0 - - - - -
- - - - - 0 0 0 i 0 - - - - -
- - - - - 0 0 0 0 0 - - - - -
0 0 0 0 0 0 0 0 0 0 0 0 0 0 0
0 c 0 0 0 0 1 2 3 0 i 0 0 0 0
0 0 0 0 0 0 3 1 2 0 0 0 0 0 0
0 0 0 b 0 0 2 3 1 0 0 0 0 0 0
0 0 0 0 0 0 0 0 0 0 0 0 b 0 0
- - - - - 0 0 x 0 0 - - - - -
- - - - - 0 x x x 0 - - - - -
- - - - - 0 0 x c 0 - - - - -
- - - - - 0 0 0 0 0 - - - - -
- - - - - 0 0 0 0 0 - - - - -
6 0 0 <-> 9 1 1
7 14 4 <-> 7 0 0
