3
0
0 2
26 41
- - - 0 0 0 - - - - - - - - - 0 0 0 0 - - - - - - - - - - - - - - - - - - - - - - 
- - 0 0 0 0 0 - - - - - - - 0 0 0 0 0 0 - - - - - - - - - - - - - - - - - - - - - 
- 0 0 0 0 0 0 0 - - - - - 0 0 0 0 0 0 0 0 - - - - - - 0 0 0 - - - - - - - - - - - 
- - 0 0 0 0 0 - - - - - - 0 0 0 0 0 0 0 0 - - - - 0 0 0 0 0 0 0 - - - - - - - - - 
- - - 0 0 0 - - - - - - - - 0 0 0 0 0 0 - - - - 0 0 0 0 0 0 0 0 0 - - - - - - - - 
- - - - - - - - - - 0 0 - - - 0 0 0 0 - - - - 0 0 0 0 0 0 0 0 0 0 0 - - - - - - - 
- - - - - - - - - 0 0 0 0 - - - - - - - - - 0 0 0 0 0 0 0 0 0 0 0 0 0 - - - - - - 
- - - - - - - - 0 0 0 0 0 0 - - - - - - - - 0 0 0 0 0 0 0 0 0 0 0 0 0 - - - - - - 
- - - - 0 - - - - 0 0 0 0 - - - - - - - - - 0 0 0 0 0 0 0 0 0 0 0 0 0 - - - - - - 
- - - 0 0 0 - - - - 0 0 - - - - 0 0 - - - - - 0 0 0 0 0 0 0 0 0 0 0 - - - - - - - 
- - 0 0 0 0 0 - - - - - - - - 0 0 0 0 - - - - - 0 0 0 0 0 0 0 0 0 - - - - - - - - 
- 0 0 2 3 1 0 0 - - - - - - 0 0 0 0 0 0 - - - - - 0 0 0 0 0 0 0 - - - - - b b - - 
0 0 0 1 2 3 0 0 0 - - - - 0 0 0 0 0 0 0 0 - - - - - - 0 0 0 - - - - - - b b b b - 
- 0 0 3 1 2 0 0 - - - - - 0 0 0 0 0 0 0 0 - - - - - - - - - - - - - - b b b b b b 
- - 0 0 0 0 0 - - - - - - - 0 0 0 0 0 0 - - - 0 0 0 - - - - - - - - - b b b b b b 
- - - 0 0 0 - - - - - - - - - 0 0 0 0 - - - 0 0 0 0 0 - - - - - - - - - b b b b - 
- - - - 0 - - - - 0 0 0 - - - - 0 0 - - - - 0 0 0 0 0 - - - - - - - - - - b b - - 
- - - - - - - 0 0 0 0 0 0 0 - - - - - - - - 0 0 0 0 0 - - - 0 0 - - - - - - - - - 
- - - - - - 0 0 0 0 0 0 0 0 0 - - - - - - - - 0 0 0 - - - 0 0 0 0 - - - - - - - - 
- - - - - 0 0 0 0 0 0 0 0 0 0 0 - - - - - - - - - - - - 0 0 0 0 0 0 - - - - - - - 
- - - - - 0 0 0 0 0 0 0 0 0 0 0 - - - - - 0 0 - - - - 0 0 0 0 0 0 0 0 - - - - - - 
- - - - - 0 0 0 0 0 0 0 0 0 0 0 - - - - 0 0 0 0 - - - 0 0 0 0 0 0 0 0 - - - - - - 
- - - - - - 0 0 0 0 0 0 0 0 0 - - - - 0 0 0 0 0 0 - - - 0 0 0 0 0 0 - - - - - - - 
- - - - - - - 0 0 0 0 0 0 0 - - - - - 0 0 0 0 0 0 - - - - 0 0 0 0 - - - - - - - - 
- - - - - - - - - 0 0 0 - - - - - - - - 0 0 0 0 - - - - - - 0 0 - - - - - - - - - 
- - - - - - - - - - - - - - - - - - - - - 0 0 - - - - - - - - - - - - - - - - - - 
7 2 2 <-> 8 12 2
4 4 4 <-> 4 8 0
1 2 7 <-> 1 11 7
5 0 2 <-> 4 16 4
7 11 1 <-> 9 8 5
6 3 3 <-> 9 6 7
6 14 2 <-> 11 9 4
13 7 1 <-> 15 5 5
10 5 0 <-> 13 3 6
12 8 3 <-> 18 5 3
11 8 3 <-> 20 2 2
5 15 3 <-> 14 14 5
18 0 2 <-> 19 11 1
2 14 6 <-> 13 13 6
2 3 5 <-> 14 11 7
12 6 2 <-> 16 9 0
17 16 4 <-> 27 12 4
20 13 3 <-> 34 7 2
20 12 2 <-> 22 6 6
15 15 5 <-> 25 3 7
3 15 5 <-> 5 21 6
31 11 3 <-> 13 23 3
29 2 1 <-> 15 19 1
33 5 2 <-> 15 20 2
8 23 5 <-> 14 1 7
12 17 0 <-> 13 12 6
6 18 7 <-> 5 4 3
23 17 5 <-> 15 21 2
25 15 1 <-> 32 10 3
26 17 2 <-> 11 24 2
22 16 6 <-> 14 18 1
24 14 0 <-> 24 10 5
10 24 4 <-> 13 17 1
19 22 6 <-> 14 22 2
20 24 5 <-> 9 24 5
24 22 1 <-> 26 16 2
22 25 4 <-> 34 8 2
21 20 0 <-> 19 14 3
23 21 2 <-> 28 22 6
24 23 3 <-> 30 24 4
19 23 5 <-> 32 18 1
33 9 4 <-> 31 17 0
31 3 1 <-> 33 19 2
24 4 7 <-> 29 18 6
22 8 6 <-> 30 17 7
27 2 0 <-> 27 21 6
34 20 2 <-> 37 16 4
32 23 3 <-> 37 11 0
34 21 2 <-> 39 15 3
31 24 4 <-> 40 13 2
35 13 7 <-> 29 12 3
39 12 1 <-> 33 19 1
35 14 6 <-> 34 6 2
36 12 7 <-> 29 23 5
