3
4
2 1
13 20
- - - - - - - - - - - - - - - - - - - - 
- - - - - - - - - - - - - - - - - - - - 
- - - - - - - - - 0 0 0 0 0 0 0 0 - - - 
- - - - - - - - - x 0 0 0 0 0 0 x - - - 
- - - - - - - - - b 0 0 3 2 0 0 b - - - 
- - - - - - - - - x 0 0 2 3 0 0 x - - - 
- - - - - - - - - 0 0 0 0 0 0 0 0 - - - 
- - - - - b 0 0 0 0 0 0 0 0 0 0 0 0 0 b 
- - - - - 0 0 0 0 0 0 0 0 0 0 0 0 0 0 0 
- - - - - x 0 2 1 0 0 0 x x 0 0 1 3 0 x 
- - - - - x 0 1 2 0 0 0 x x 0 0 3 1 0 x 
- - - - - 0 0 0 0 0 0 0 x x 0 0 0 0 0 0 
- - - - - b 0 0 0 0 0 0 0 0 0 0 0 0 0 b 
19 9 2 <-> 5 9 6
19 10 2 <-> 5 10 6
19 12 3 <-> 9 2 7
5 12 5 <-> 16 2 1
16 3 2 <-> 9 3 6
16 5 2 <-> 9 5 6
11 12 4 <-> 11 2 0
14 12 4 <-> 14 2 0
