3
2
2 1
23 34
- - - - - - - - - - - - - - - - - - - - - - - - - - - - - - - - - - 
- - - - - - - - - - - - - - - - - - - - - - - - - - - - - - - - - - 
- c b b b b b b b b c - - - - - - - - - - - - - c b b b b b b b b c 
- b x x 0 0 0 0 x x b - - - - - - - - - - - - - b x x 0 0 0 0 x x b 
- b x x 0 0 0 0 x x b - - - - - - - - - - - - - b x x 0 0 0 0 x x b 
- b 0 0 0 0 0 0 0 0 b - - - - - - - - - - - - - b 0 0 0 0 0 0 0 0 b 
- b i 0 0 1 2 0 0 0 b - - - - - - - - - - - - - b i 0 0 2 3 0 0 0 b 
- b 0 0 0 2 1 0 0 i b - - - - - - - - - - - - - b 0 0 0 3 2 0 0 i b 
- b 0 0 0 0 0 0 0 0 b - - - - - - - - - - - - - b 0 0 0 0 0 0 0 0 b 
- b x x 0 0 0 0 x x b - - - - - - - - - - - - - b x x 0 0 0 0 x x b 
- b x x 0 0 0 0 x x b - - - - - - - - - - - - - b x x 0 0 0 0 x x b 
- c b b b b b b b b c - - - - - - - - - - - - - c b b b b b b b b c 
- - - - - - - - - - - - - - - - - - - - - - - - - - - - - - - - - - 
- - - - - - - - - - - - c b b b b b b b b b c - - - - - - - - - - - 
- - - - - - - - - - - - b x x 0 0 0 0 0 x x b - - - - - - - - - - - 
- - - - - - - - - - - - b x x 0 0 0 0 0 x x b - - - - - - - - - - - 
- - - - - - - - - - - - b 0 0 0 0 0 0 0 0 0 b - - - - - - - - - - - 
- - - - - - - - - - - - b i 0 0 3 1 0 0 0 0 b - - - - - - - - - - - 
- - - - - - - - - - - - b 0 0 0 1 3 0 0 0 i b - - - - - - - - - - - 
- - - - - - - - - - - - b 0 0 0 0 0 0 0 0 0 b - - - - - - - - - - - 
- - - - - - - - - - - - b x x 0 0 0 0 0 x x b - - - - - - - - - - - 
- - - - - - - - - - - - b x x 0 0 0 0 0 x x b - - - - - - - - - - - 
- - - - - - - - - - - - c b b b b b b b b b c - - - - - - - - - - - 
10 3 2 <-> 24 3 6
10 5 2 <-> 24 5 6
10 6 2 <-> 24 6 6
10 7 2 <-> 24 7 6
10 8 2 <-> 24 8 6
10 9 2 <-> 24 9 6
10 10 2 <-> 24 10 6
9 11 3 <-> 12 14 7
8 11 3 <-> 12 15 7
7 11 3 <-> 12 16 7
6 11 3 <-> 12 17 7
5 11 3 <-> 12 18 7
4 11 3 <-> 12 19 7
3 11 3 <-> 12 20 7
10 4 2 <-> 24 4 6
2 11 3 <-> 12 21 7
25 11 5 <-> 22 14 1
26 11 5 <-> 22 15 1
27 11 5 <-> 22 16 1
28 11 5 <-> 22 17 1
22 18 1 <-> 29 11 5
30 11 5 <-> 22 19 1
31 11 5 <-> 22 20 1
32 11 5 <-> 22 21 1
