3
0
0 0
23 33
- - - - - - - - - - - - - - - - - - - - - - - - - - - - - - - - - 
- - - - - - - - - - - - - - - - - - - - - - - - - - - - - - - - - 
- - - - - - - - - - - 0 0 0 0 0 0 0 0 0 0 0 0 0 0 - - - - - - - - 
- - - - - - - - - - - 0 i 0 0 0 0 0 0 0 0 0 0 c 0 - - - - - - - - 
- - - - - - - - - - - 0 0 0 0 0 0 0 0 0 0 0 0 0 0 - - - - - - - - 
- - - - - - - - - - - 0 0 0 0 0 3 - - 1 0 0 0 0 0 - - - - - - - - 
- - - - - - - - - - - 0 0 0 0 0 0 3 1 0 0 0 0 0 0 - - - - - - - - 
- - - - - - - - - - - 0 0 0 0 0 0 1 3 0 0 0 0 0 0 - - - - - - - - 
- - - - - - - - - - - 0 0 0 0 0 0 0 0 0 0 0 0 0 0 - - - - - - - - 
- - - - - - - - - - - 0 0 0 0 0 0 0 0 0 0 0 0 0 0 - - - - - - - - 
- - - - - - - - - - - 0 0 0 0 0 0 0 0 0 0 0 0 0 0 - - - - - - - - 
- - - - - - - - - - - 0 0 b 0 0 0 0 0 0 0 0 b 0 0 - - - - - - - - 
- - 0 0 0 0 0 0 0 0 0 0 0 b 0 0 - - - - 0 0 b 0 0 0 0 0 0 0 0 0 0 
- - 0 0 0 0 0 0 0 0 0 0 0 0 0 0 - - - - 0 0 0 0 0 0 0 0 0 0 0 0 0 
- - 0 0 0 0 0 0 0 0 0 0 0 0 0 0 - - - - 0 0 0 0 0 0 0 0 0 0 0 0 0 
- - 0 0 0 0 0 0 0 0 0 0 0 0 0 0 - - - - 0 0 0 0 0 0 0 0 0 0 0 0 0 
- - 0 0 0 0 0 2 - - 3 0 0 0 0 0 - - - - 0 0 0 0 0 1 - - 2 0 0 0 0 
- - 0 0 0 0 0 0 2 3 0 0 0 0 0 0 - - - - 0 0 0 0 0 0 1 2 0 0 0 0 0 
- - 0 0 0 0 0 0 3 2 0 0 0 0 0 0 - - - - 0 0 0 0 0 0 2 1 0 0 0 0 0 
- - 0 0 0 0 0 0 0 0 0 0 0 0 0 0 - - - - 0 0 0 0 0 0 0 0 0 0 0 0 0 
- - 0 0 0 0 0 0 0 0 0 0 0 0 0 0 - - - - 0 0 0 0 0 0 0 0 0 0 0 0 0 
- - 0 i 0 0 0 0 0 0 0 0 0 0 0 0 - - - - 0 0 0 0 0 0 0 0 0 0 0 c 0 
- - 0 0 0 0 0 0 0 0 0 0 0 0 0 0 - - - - 0 0 0 0 0 0 0 0 0 0 0 0 0 
15 21 2 <-> 20 21 6
15 14 2 <-> 20 14 6
2 22 5 <-> 32 22 3
2 12 7 <-> 11 2 7
32 12 1 <-> 24 2 1
25 12 0 <-> 24 11 2
10 12 0 <-> 11 11 6
15 17 2 <-> 20 17 6
