3
5
2 3
45 45
- - - - - - - - - - - - - - - - - - - - - - - - - - - - - - - - - - - - - - - - - - - - - 
- 0 0 0 0 0 0 0 0 0 0 0 0 0 0 0 0 0 0 0 0 0 0 - 0 0 0 0 0 0 0 0 0 0 0 0 0 0 0 0 0 0 0 0 0 
- 0 0 0 0 0 0 0 0 0 0 0 0 0 0 0 0 0 0 0 0 0 0 - 0 0 0 0 0 0 0 0 0 0 0 0 0 0 0 0 0 0 0 0 0 
- 0 0 0 0 0 0 0 0 0 0 0 0 0 0 0 0 0 0 0 0 0 0 - 0 0 0 0 0 0 0 0 0 0 0 0 0 0 0 0 0 0 0 0 0 
- 0 0 0 0 0 0 0 0 0 c 0 0 0 0 0 0 0 0 0 0 0 0 - 0 0 0 0 b 0 0 0 0 0 0 0 0 0 0 0 0 0 0 0 0 
- 0 0 0 0 0 0 0 0 0 0 0 0 0 0 0 0 0 0 0 0 0 0 - 0 0 0 0 0 0 0 0 0 0 x 0 0 0 0 0 0 0 0 0 0 
- 0 0 0 0 0 0 0 0 0 0 0 0 0 0 0 0 0 0 0 0 0 0 - 0 0 0 0 0 0 0 0 0 x x x 0 0 0 0 0 0 0 0 0 
- 0 0 0 0 0 0 0 0 0 - - - 0 0 0 0 0 0 0 0 0 0 - 0 0 0 0 0 0 0 0 x x x x x 0 0 0 0 0 0 0 0 
- 0 0 0 0 0 0 0 0 0 0 0 0 0 0 0 0 0 0 0 0 0 0 - 0 0 0 0 0 0 0 x x - - - x x 0 0 0 0 0 0 0 
- 0 0 0 0 0 0 0 0 0 0 0 0 0 0 0 0 0 0 0 0 0 0 - 0 0 0 0 0 0 x x x - - - x x x 0 0 0 0 0 0 
- 0 0 0 0 0 - 0 0 0 1 3 2 0 0 0 - 0 0 0 0 0 0 - 0 0 0 0 0 0 0 x x - - - x x 0 0 0 0 0 0 0 
- 0 0 0 0 0 - 0 0 0 2 1 3 0 0 0 - 0 0 0 0 0 0 - 0 0 0 0 0 0 0 0 x x x x x 0 0 0 0 0 0 0 0 
- 0 0 0 0 0 - 0 0 0 3 2 1 0 0 0 - 0 0 0 0 0 0 - 0 0 0 0 0 0 0 0 0 x x x 0 0 0 0 0 0 0 0 0 
- 0 0 0 0 0 0 0 0 0 0 0 0 0 0 0 0 c 0 0 0 0 0 - 0 0 0 0 0 0 0 0 0 0 x 0 0 0 0 0 0 0 0 0 0 
- 0 0 0 0 0 0 0 0 0 0 0 0 0 0 0 0 0 0 0 0 0 0 - 0 0 0 0 0 0 0 0 0 0 0 0 0 0 0 0 0 0 0 0 0 
- 0 0 0 0 0 0 0 0 0 - - - 0 0 0 0 0 0 0 0 0 0 - 0 0 0 0 0 0 0 0 0 0 0 0 0 0 0 b 0 0 0 0 0 
- 0 0 0 0 0 0 0 0 0 0 0 0 0 0 0 0 0 0 0 0 0 0 - 0 0 0 0 0 0 0 0 0 0 0 0 0 0 0 0 0 0 0 0 0 
- 0 0 0 0 0 0 0 0 0 0 0 0 0 0 0 0 0 0 0 0 0 0 - 0 0 0 0 0 0 0 0 0 0 0 0 0 0 0 0 0 0 0 0 0 
- 0 0 0 0 c 0 0 0 0 0 0 0 0 c 0 0 0 0 0 0 0 0 - 0 0 0 0 0 b 0 0 0 0 0 0 0 0 0 0 0 0 0 0 0 
- 0 0 0 0 0 0 0 0 0 0 0 0 0 0 0 0 0 0 0 0 0 0 - 0 0 0 0 0 0 0 0 0 0 0 b 0 0 0 0 0 0 0 0 0 
- 0 0 0 0 0 0 0 0 0 0 0 0 0 0 0 0 0 0 0 0 0 0 - 0 0 0 0 0 0 0 0 0 0 0 0 0 0 0 0 0 0 0 0 0 
- 0 0 0 0 0 0 0 0 0 0 0 0 0 0 0 0 0 0 0 0 0 0 - 0 0 0 0 0 0 0 0 0 0 0 0 0 0 0 0 0 0 0 0 0 
- 0 0 0 0 0 0 0 0 0 0 0 0 0 0 0 0 0 0 0 0 0 - - - 0 0 0 0 0 0 0 0 0 0 0 0 0 0 0 0 0 0 0 0 
- - - - - - - - - - - - - - - - - - - - - - - i - - - - - - - - - - - - - - - - - - - - - 
- 0 0 0 0 0 0 0 0 0 0 0 0 0 0 0 0 0 0 0 0 0 - - - - - - - - - - - - - - - - - - - - - - - 
- 0 0 0 0 0 0 0 0 0 0 0 0 0 0 0 0 0 0 0 0 0 0 - - - - - - - - - - - - - - - - - - - - - - 
- 0 0 0 0 0 0 0 0 0 0 0 0 0 0 0 0 0 0 0 0 0 0 - - - - - - - - - - - - - - - - - - - - - - 
- 0 0 0 0 0 0 0 0 0 0 c 0 0 0 0 0 0 0 0 0 0 0 - - - - - - - - - - - - - - - - - - - - - - 
- 0 0 0 0 0 0 0 0 0 0 0 0 0 0 0 0 0 0 0 0 0 0 - - - - - - - - - - - - - - - - - - - - - - 
- 0 0 0 0 0 0 0 0 0 x 0 0 0 0 0 0 0 0 0 0 0 0 - - - - - - - - - - - - - - - - - - - - - - 
- 0 0 0 0 0 0 0 0 x x x 0 0 0 0 0 0 0 0 0 0 0 - - - - - - - - - - - - - - - - - - - - - - 
- 0 0 0 0 0 0 0 x x x x x 0 0 0 0 0 0 0 0 0 0 - - - - - - - - - - - - - - - - - - - - - - 
- 0 0 0 0 0 0 x x - - - x x 0 0 0 0 0 0 0 0 0 - - - - - - - - - - - - - - - - - - - - - - 
- 0 0 0 0 0 x x x - - - x x x 0 0 0 0 0 0 0 0 - - - - - - - - - - - - - - - - - - - - - - 
- 0 0 0 0 0 0 x x - - - x x 0 0 0 0 0 0 0 0 0 - - - - - - - - - - - - - - - - - - - - - - 
- 0 0 0 0 0 0 0 x x x x x 0 0 0 0 0 0 0 0 0 0 - - - - - - - - - - - - - - - - - - - - - - 
- 0 0 0 0 0 0 0 0 x x x 0 0 0 0 0 0 b 0 0 0 0 - - - - - - - - - - - - - - - - - - - - - - 
- 0 0 0 0 0 0 0 0 0 x 0 0 0 0 0 0 0 0 0 0 0 0 - - - - - - - - - - - - - - - - - - - - - - 
- 0 0 0 0 0 0 0 0 0 0 0 0 0 0 0 0 0 0 0 0 0 0 - - - - - - - - - - - - - - - - - - - - - - 
- 0 0 0 0 0 0 0 0 0 0 0 0 0 0 0 0 0 0 0 0 0 0 - - - - - - - - - - - - - - - - - - - - - - 
- 0 0 0 0 0 0 0 0 0 0 0 0 0 c 0 0 0 0 0 0 0 0 - - - - - - - - - - - - - - - - - - - - - - 
- 0 0 0 0 b 0 0 0 0 0 0 0 0 0 0 0 0 0 0 0 0 0 - - - - - - - - - - - - - - - - - - - - - - 
- 0 0 0 0 0 0 0 0 0 0 0 0 0 0 0 0 0 0 0 0 0 0 - - - - - - - - - - - - - - - - - - - - - - 
- 0 0 0 0 0 0 0 0 0 0 0 0 0 0 0 0 0 0 0 0 0 0 - - - - - - - - - - - - - - - - - - - - - - 
- 0 0 0 0 0 0 0 0 0 0 0 0 0 0 0 0 0 0 0 0 0 0 - - - - - - - - - - - - - - - - - - - - - - 
22 1 2 <-> 21 24 0
20 24 0 <-> 22 2 2
19 24 0 <-> 22 3 2
18 24 0 <-> 22 4 2
17 24 0 <-> 22 5 2
16 24 0 <-> 22 6 2
15 24 0 <-> 22 7 2
14 24 0 <-> 22 8 2
13 24 0 <-> 22 9 2
12 24 0 <-> 22 10 2
11 24 0 <-> 22 11 2
10 24 0 <-> 22 12 2
9 24 0 <-> 22 13 2
8 24 0 <-> 22 14 2
6 24 0 <-> 22 16 2
7 24 0 <-> 22 15 2
5 24 0 <-> 22 17 2
4 24 0 <-> 22 18 2
3 24 0 <-> 22 19 2
2 24 0 <-> 22 20 2
1 24 0 <-> 22 21 2
22 25 2 <-> 25 22 4
22 26 2 <-> 26 22 4
22 27 2 <-> 27 22 4
22 28 2 <-> 28 22 4
22 29 2 <-> 29 22 4
22 30 2 <-> 30 22 4
31 22 4 <-> 22 31 2
22 32 2 <-> 32 22 4
33 22 4 <-> 22 33 2
22 34 2 <-> 34 22 4
35 22 4 <-> 22 35 2
22 36 2 <-> 36 22 4
37 22 4 <-> 22 37 2
22 38 2 <-> 38 22 4
39 22 4 <-> 22 39 2
22 40 2 <-> 40 22 4
41 22 4 <-> 22 41 2
42 22 4 <-> 22 42 2
43 22 4 <-> 22 43 2
44 22 4 <-> 22 44 2
21 21 3 <-> 21 25 1
24 1 0 <-> 22 1 0
25 1 0 <-> 21 1 0
26 1 0 <-> 20 1 0
27 1 0 <-> 19 1 0
28 1 0 <-> 18 1 0
29 1 0 <-> 17 1 0
30 1 0 <-> 16 1 0
31 1 0 <-> 15 1 0
32 1 0 <-> 14 1 0
33 1 0 <-> 13 1 0
34 1 0 <-> 12 1 0
35 1 0 <-> 11 1 0
36 1 0 <-> 10 1 0
37 1 0 <-> 9 1 0
38 1 0 <-> 8 1 0
39 1 0 <-> 7 1 0
40 1 0 <-> 6 1 0
41 1 0 <-> 5 1 0
4 1 0 <-> 42 1 0
3 1 0 <-> 43 1 0
2 1 0 <-> 44 1 0
15 10 2 <-> 36 8 6
36 9 6 <-> 15 11 2
15 12 2 <-> 36 10 6
12 14 4 <-> 35 11 0
11 14 4 <-> 34 11 0
10 14 4 <-> 33 11 0
7 12 6 <-> 32 10 2
7 11 6 <-> 32 9 2
7 10 6 <-> 32 8 2
10 8 0 <-> 33 7 4
11 8 0 <-> 34 7 4
12 8 0 <-> 35 7 4
13 8 7 <-> 32 11 1
15 13 1 <-> 36 11 7
13 16 7 <-> 36 7 5
7 13 7 <-> 32 7 3
9 14 3 <-> 8 35 1
10 14 3 <-> 9 35 1
11 14 3 <-> 10 35 1
12 35 7 <-> 15 12 1
12 34 7 <-> 15 11 1
12 33 7 <-> 15 10 3
12 31 5 <-> 12 8 7
11 31 5 <-> 11 8 7
10 31 5 <-> 9 8 1
8 31 3 <-> 7 9 5
8 32 3 <-> 7 10 5
8 33 3 <-> 7 11 5
