3
4
2 3
34 34
- - - - - 0 0 0 0 - - - - - - - - - - - - - 0 0 0 0 - - - - - - - - 
- 0 0 0 0 0 0 0 0 0 0 - - 0 0 0 - - 0 0 0 0 0 0 0 0 0 0 - - 0 0 0 - 
- 0 0 0 0 0 0 0 0 0 0 - - 0 0 0 - - 0 0 0 0 0 0 0 0 0 0 - - 0 0 0 - 
- 0 0 0 0 0 0 0 0 0 0 - - 0 0 - - - 0 0 0 0 0 0 0 0 0 0 - - 0 0 - - 
- - - - - - - - 0 0 0 - - 0 0 0 - - - - - - - - - 0 0 0 - - 0 0 0 - 
- - - - - - - - 0 0 0 - - 0 0 0 - - - - - - - - - 0 0 0 - - 0 0 0 - 
0 0 0 0 0 0 - - 0 - - - - 0 0 0 0 0 0 0 0 0 0 - - 0 - - - - 0 0 0 0 
0 0 0 0 0 0 - - 0 - - - - 0 x x x x x x x x 0 - - 0 - - - - 0 0 0 0 
0 0 0 - 0 0 - - 0 0 0 0 0 0 0 0 0 0 0 0 - 0 0 - - 0 0 0 0 0 0 0 0 0 
- 0 0 - 0 0 - - 0 0 0 0 0 0 0 0 - - 0 0 - 0 0 - - 0 0 0 0 0 0 0 0 - 
- 0 x - 0 0 - - 0 0 0 - - - - - - - 0 0 - 0 0 - - 0 0 0 - - - - - - 
- 0 0 - 0 0 - 0 0 0 0 - - - - - - - 0 0 - 0 0 - 0 0 0 0 - - - - - - 
- 0 0 - 0 0 - 0 0 0 0 - 0 0 0 0 - - 0 0 - 0 0 - 0 0 0 0 - 0 0 0 0 - 
- 0 0 - 0 0 0 0 0 0 0 0 0 0 0 0 - - 0 0 - 0 0 0 0 0 0 0 0 0 0 0 0 - 
- 0 0 - 0 0 0 0 0 0 0 0 0 0 0 0 - - 0 0 - 0 0 0 0 0 0 0 0 0 0 0 0 - 
- - - - - 0 1 3 0 - - - - - - - - - - - - - 0 0 0 0 - - - - - - - - 
- - - - - 0 3 1 0 - - - - - - - - - - - - - 0 0 0 0 - - - - - - - - 
- 0 0 0 0 0 0 0 0 0 0 - - 0 0 0 - - 0 0 0 0 0 x 0 0 0 0 - - 0 0 0 - 
- 0 0 0 0 0 0 0 0 0 0 - - 0 0 0 - - 0 0 0 0 0 0 x 0 0 0 - - 0 0 0 - 
- 0 0 0 0 0 0 0 0 0 0 - - 0 0 - - - 0 0 0 0 0 0 0 x 0 0 - - 0 0 - - 
- - - - - - - - 0 0 0 - - 0 0 0 - - - - - - - - - 0 x 0 - - 0 0 0 - 
- - - - - - - - 0 0 0 - - 0 0 0 - - - - - - - - - 0 0 0 - - 0 0 0 - 
0 0 0 0 0 0 - - 0 - - - - 0 0 0 0 0 0 0 0 0 0 - - x - - - - 0 1 2 0 
0 0 0 0 0 0 - - 0 - - - - 0 x x x x x 0 0 0 0 - - x - - - - 0 2 1 0 
0 0 0 - 0 0 - - 0 0 0 0 0 0 0 0 0 0 0 0 - 0 0 - - 0 0 0 0 0 0 0 0 0 
- 0 0 - 0 0 - - 0 0 0 0 0 0 0 0 - - 0 0 - 0 0 - - 0 0 0 0 0 0 0 0 - 
- 0 0 - 0 0 - - 0 0 0 - - - - - - - 0 0 - 0 0 - - 0 0 0 - - - - - - 
- 0 0 - 0 0 - 0 0 0 0 - - - - - - - 0 0 - 0 0 - 0 0 0 0 - - - - - - 
- 0 0 - 0 0 - 0 2 3 0 - 0 0 0 0 - - 0 0 - 0 0 - 0 0 0 0 - 0 0 0 0 - 
- 0 0 - 0 0 0 0 3 2 0 0 0 0 0 0 - - 0 0 - 0 0 0 0 0 0 0 0 0 0 0 0 - 
- 0 0 - 0 0 0 0 0 0 0 0 0 0 0 0 - - 0 0 - 0 0 0 0 0 0 0 0 0 0 0 0 - 
- - - - - 0 0 0 0 - - - - - - - - - 0 0 - - 0 0 0 0 - - - - - - - - 
- - - - 0 0 0 0 0 0 0 0 0 0 0 0 - - 0 0 - 0 0 0 0 0 0 0 0 0 0 0 0 - 
- - - - - 0 0 0 0 - - - - - - - - - - - - - 0 0 0 0 - - - - - - - - 
