3
0
1 1
16 15
c 0 0 0 0 0 3 1 3 0 0 0 0 0 c 
c 0 0 0 0 0 1 3 1 0 0 0 0 0 c 
- 0 0 0 0 0 0 0 0 0 0 0 0 0 - 
- - 0 0 0 0 0 0 0 0 0 0 0 - - 
- - - 0 0 0 0 0 0 0 0 0 - - - 
- - - - 0 0 0 0 0 0 0 - - - - 
- - - - - 0 0 0 0 0 - - - - - 
- - - - - - 1 2 1 - - - - - - 
- - - - - - 2 1 2 - - - - - - 
- - - - - 0 0 0 0 0 - - - - - 
- - - - 0 0 0 0 0 0 0 - - - - 
- - - 0 0 0 0 0 0 0 0 0 - - - 
- - 0 0 0 0 0 0 0 0 0 0 0 - - 
- 0 0 0 0 0 0 0 0 0 0 0 0 0 - 
c 0 0 0 0 0 2 3 2 0 0 0 0 0 c 
c 0 0 0 0 0 3 2 3 0 0 0 0 0 c 
