3
4
2 2
26 47
- - - - - - - - - - - - - - - - - - - - - - - - - - - - - - - - - - - - - - - - - - - - - - - 
- - - - - - - - - - - - - - - - - - - - - - - - - - - - - - - - - - - - - - - - - - - - - - - 
- - - - - - - - - - 0 0 0 0 0 0 0 0 0 0 0 0 0 0 0 0 0 0 0 0 0 0 0 0 0 0 0 0 0 - 0 0 0 - - - - 
- - - - - 0 0 0 0 0 0 0 0 0 0 0 0 0 0 0 0 0 0 0 0 0 0 0 0 0 0 0 0 0 0 0 0 c 0 - 0 0 0 - - - - 
- - - - - 0 0 0 0 0 0 0 0 0 0 0 0 0 0 0 0 0 0 0 0 0 0 0 0 0 0 0 0 0 0 0 0 c 0 - 0 0 0 - - - - 
- - - - - - - - - - 0 0 0 0 0 0 0 0 0 0 0 0 0 0 0 0 0 0 0 0 0 0 0 0 0 0 0 0 0 - 0 0 0 0 - - - 
- - - - - - - - - - - - - - - - - 0 0 0 0 0 0 0 0 0 0 - - - - - - - - - - - - - - 0 0 0 - - - 
- - - - - - - - - - - - - - - - - 0 0 0 0 0 0 0 0 0 0 - - - - - - - - - - - - - - 0 0 0 - - - 
- - - - - - - 0 0 0 0 0 0 0 0 0 0 0 0 0 0 0 0 0 0 0 0 0 0 0 0 0 0 0 - - - - - - - 0 0 0 0 - - 
- - - - - - 0 0 0 0 0 0 0 0 0 0 0 0 0 0 0 0 0 0 0 0 0 0 0 0 0 0 0 0 0 0 - - - - - - 0 0 0 - - 
- - - 0 0 0 0 0 0 0 1 3 0 0 0 0 0 0 0 0 0 0 0 0 0 0 0 0 0 0 0 0 0 0 0 0 0 0 - - - - 0 0 0 - - 
- - 0 0 0 0 0 0 0 0 3 1 0 0 0 0 0 0 0 0 0 0 0 0 0 0 0 0 0 0 0 0 0 0 0 0 0 0 0 - - - 0 0 0 0 - 
- - - - - 0 0 0 0 0 0 0 0 0 0 0 - b 0 0 0 0 0 0 0 0 b - 0 0 0 0 0 0 0 0 0 b 0 - - - - 0 0 0 0 
- - - - - 0 0 0 0 0 2 1 0 0 0 0 - b 0 0 0 0 0 0 0 0 b - 0 0 0 0 0 0 0 0 0 b 0 0 - - - 0 b b 0 
- - - - - 0 0 0 0 0 1 2 0 0 0 0 - b 0 0 0 0 0 0 0 0 b - 0 0 0 0 0 0 0 0 0 b 0 0 - - - 0 b b 0 
- - - - - 0 0 0 0 0 0 0 0 0 0 0 - b 0 0 0 0 0 0 0 0 b - 0 0 0 0 0 0 0 0 0 b 0 - - - - 0 0 0 0 
- - 0 0 0 0 0 0 0 0 3 2 0 0 0 0 0 0 0 0 0 0 0 0 0 0 0 0 0 0 0 0 0 0 0 0 0 0 0 - - - 0 0 0 0 - 
- - - 0 0 0 0 0 0 0 2 3 0 0 0 0 0 0 0 0 0 0 0 0 0 0 0 0 0 0 0 0 0 0 0 0 0 0 - - - - 0 0 0 - - 
- - - - - - 0 0 0 0 0 0 0 0 0 0 0 0 0 0 0 0 0 0 0 0 0 0 0 0 0 0 0 0 0 0 - - - - - - 0 0 0 - - 
- - - - - - - 0 0 0 0 0 0 0 0 0 0 0 0 0 0 0 0 0 0 0 0 0 0 0 0 0 0 0 - - - - - - - 0 0 0 0 - - 
- - - - - - - - - - - - - - - - - 0 0 0 0 0 0 0 0 0 0 - - - - - - - - - - - - - - 0 0 0 - - - 
- - - - - - - - - - - - - - - - - 0 0 0 0 0 0 0 0 0 0 - - - - - - - - - - - - - - 0 0 0 - - - 
- - - - - - - - - - 0 0 0 0 0 0 0 0 0 0 0 0 0 0 0 0 0 0 0 0 0 0 0 0 0 0 0 0 0 - 0 0 0 0 - - - 
- - - - - 0 0 0 0 0 0 0 0 0 0 0 0 0 0 0 0 0 0 0 0 0 0 0 0 0 0 0 0 0 0 0 0 c 0 - 0 0 0 - - - - 
- - - - - 0 0 0 0 0 0 0 0 0 0 0 0 0 0 0 0 0 0 0 0 0 0 0 0 0 0 0 0 0 0 0 0 c 0 - 0 0 0 - - - - 
- - - - - - - - - - 0 0 0 0 0 0 0 0 0 0 0 0 0 0 0 0 0 0 0 0 0 0 0 0 0 0 0 0 0 - 0 0 0 - - - - 
28 15 6 <-> 15 15 2
28 14 6 <-> 15 14 2
28 13 6 <-> 15 13 2
28 12 6 <-> 15 12 2
5 14 6 <-> 39 14 2
5 13 6 <-> 39 13 2
33 19 4 <-> 33 8 0
32 19 4 <-> 32 8 0
7 8 0 <-> 7 19 4
8 8 0 <-> 8 19 4
17 20 6 <-> 26 20 2
26 21 2 <-> 17 21 6
17 6 6 <-> 26 6 2
26 7 2 <-> 17 7 6
27 16 0 <-> 27 11 4
16 11 4 <-> 16 16 0
38 22 2 <-> 40 22 6
38 25 2 <-> 40 25 6
38 24 2 <-> 40 24 6
38 23 2 <-> 40 23 6
38 5 2 <-> 40 5 6
38 4 2 <-> 40 4 6
38 3 2 <-> 40 3 6
38 2 2 <-> 40 2 6
37 25 4 <-> 41 25 4
36 25 4 <-> 42 25 4
36 22 0 <-> 41 21 6
35 22 0 <-> 41 20 6
37 5 4 <-> 41 6 6
36 5 4 <-> 41 7 6
36 2 0 <-> 41 2 0
35 2 0 <-> 42 2 0
41 8 4 <-> 42 11 4
42 16 0 <-> 41 19 0
43 22 4 <-> 44 19 4
10 2 6 <-> 5 3 6
10 5 6 <-> 5 4 6
5 23 6 <-> 10 22 6
5 24 6 <-> 10 25 6
11 5 4 <-> 11 22 0
12 5 4 <-> 12 22 0
