3
0
4 3
27 33
0 0 0 0 0 0 0 0 0 0 0 0 0 0 0 0 0 0 0 0 0 0 0 0 0 0 0 0 0 0 0 0 0 
0 - 0 - - - 0 - - - 0 - - - 0 - - - 0 - - - 0 - - - 0 - - - 0 - 0 
0 - 0 0 0 - 0 0 0 - 0 0 0 - 0 0 0 - 0 - 0 0 0 - 0 0 0 - 0 0 0 - 0 
0 - - 0 0 0 0 0 0 0 0 0 0 0 0 0 0 0 0 0 0 0 0 0 0 0 0 0 0 0 - - 0 
0 0 0 0 0 0 0 0 0 0 0 0 0 0 0 0 0 0 0 0 0 0 0 0 0 0 0 0 i 0 0 0 0 
0 - 0 0 0 c 0 0 0 0 0 0 0 0 0 0 0 0 0 0 0 0 0 0 0 0 0 0 0 0 0 - 0 
0 - 0 0 0 0 0 0 0 0 0 0 0 0 0 0 0 0 0 0 0 0 0 0 0 0 0 0 0 0 0 - 0 
0 - - 0 0 0 0 0 0 0 0 0 0 0 - 0 0 0 - 0 0 0 0 0 0 0 0 0 0 0 - - 0 
0 0 0 0 0 0 0 0 0 0 0 0 - 0 - - - 0 - - - 0 0 0 0 0 0 0 0 0 0 0 0 
0 - 0 0 0 0 0 0 0 0 0 0 - 0 0 0 0 0 0 0 0 0 0 0 0 0 0 0 0 0 0 - 0 
0 - 0 0 0 0 0 0 0 0 0 - - 0 0 0 0 0 0 0 - - 0 0 0 0 0 0 0 0 0 - 0 
0 - - 0 0 0 0 0 0 0 0 0 0 0 0 3 2 1 0 0 - 0 0 0 0 0 0 0 0 0 - - 0 
0 0 0 0 b 0 0 0 0 0 0 0 - 0 0 1 3 2 0 0 - 0 0 0 0 0 0 0 0 0 0 0 0 
0 - - 0 0 0 0 0 0 0 0 0 - 0 0 2 1 3 0 0 0 0 0 0 0 0 0 0 0 b 0 - 0 
0 - 0 0 0 0 0 0 0 0 0 - - 0 0 0 0 0 0 0 - - 0 0 0 0 0 0 0 0 0 - 0 
0 - 0 0 0 0 0 0 0 0 0 0 0 0 0 0 0 0 0 0 - 0 0 0 0 0 0 0 0 0 - - 0 
0 0 0 0 0 0 0 0 0 0 0 0 - - - 0 - - - 0 - 0 0 0 0 0 0 0 0 0 0 0 0 
0 - - 0 0 0 0 0 0 0 0 0 0 0 - 0 0 0 - 0 0 0 0 0 0 0 0 0 0 0 - - 0 
0 - 0 0 0 0 0 0 0 0 0 0 0 0 0 0 0 0 0 0 0 0 0 0 0 0 0 0 0 0 0 - 0 
0 - 0 0 0 0 0 0 0 0 0 0 0 0 0 0 0 0 0 0 0 0 0 0 0 0 0 0 0 0 0 - 0 
0 0 0 0 0 0 0 0 0 0 0 0 0 0 0 0 0 0 0 0 0 0 0 0 0 0 0 0 0 0 0 0 0 
0 - - 0 0 0 0 0 0 0 0 0 0 0 0 0 0 0 0 0 0 0 0 0 0 0 0 0 0 0 - - 0 
0 - 0 0 i 0 0 0 0 0 0 0 0 0 0 0 0 0 0 0 0 0 0 0 0 0 0 c 0 0 0 - 0 
0 - 0 0 0 0 0 0 0 0 0 0 0 0 0 0 0 0 0 0 0 0 0 0 0 0 0 0 0 0 0 - 0 
0 0 0 - 0 0 0 - 0 0 0 - 0 0 0 - 0 - 0 0 0 - 0 0 0 - 0 0 0 - 0 0 0 
0 - - - 0 - - - 0 - - - 0 - - - 0 - - - 0 - - - 0 - - - 0 - - - 0 
0 0 0 0 0 0 0 0 0 0 0 0 0 0 0 0 0 0 0 0 0 0 0 0 0 0 0 0 0 0 0 0 0 
