3
5
1 1
10 10
3 1 0 0 0 0 0 0 3 2 
1 3 0 0 0 0 0 0 2 3 
0 0 0 0 0 0 0 0 0 0 
0 0 0 c 0 0 0 0 0 0 
0 0 0 0 b b 0 0 0 0 
0 0 0 0 b b 0 0 0 0 
0 0 0 0 0 0 i 0 0 0 
0 0 0 0 0 0 0 0 0 0 
x x 0 0 0 0 0 0 1 2 
x x 0 0 0 0 0 0 2 1 
9 9 3 <-> 0 0 7
9 0 1 <-> 0 9 5
4 0 0 <-> 4 9 4
5 0 0 <-> 5 9 4
9 4 2 <-> 0 4 6
9 5 2 <-> 0 5 6
