3
3
3 1
45 33
0 - - - - - - - - - - - - - - - - - - - - - - - - - - - - - - - 0 
- - - - - - - - - - - - - - - - - - - - - - - - - - - - - - - - - 
- - - - - i i i i i i i i i i i - i i i i i i i i i i i - - - - - 
- - - - - i - - - - - - - - - i - i - - - - - - - - - i - - - - - 
- - - - - i - i i i i i i i - i - i - i i i i i i i - i - - - - - 
- - - - - i - i - - - - - i - i - i - i - - - - - i - i - - - - - 
- - - - - i - i - 0 - i - i - i - i - i - i - 0 - i - i - - - - - 
- - - - - i - i - 0 - i - i - i - i - i - i - 0 - i - i - - - - - 
- - - - - i - i - - - i - i - i - i - i - i - - - i - i - - - - - 
- - - - - i - i i i i i - i - i - i - i - i i i i i - i - - - - - 
- - - - - i - - - - - - - i - i - i - i - - - - - - - i - - - - - 
- - - - - i i i i i i i i i - i - i - i i i i i i i i i - - - - - 
- - - - - - - - - - - - - - - i - i - - - - - - - - - - - - - - - 
- - - - - - - - - - - - - - - i - i - - - - - - - - - - - - - - - 
- - - - - - - - - - - - - - - - - - - - - - - - - - - - - - - - - 
- - - 0 0 0 0 0 0 0 0 0 0 0 0 0 0 0 0 0 0 0 0 0 0 0 0 0 0 0 - - - 
- - - 0 0 - 0 b 0 0 0 0 0 0 0 b 0 b 0 0 0 0 0 0 0 b 0 - 0 0 - - - 
- - - 0 0 0 0 b 0 0 0 0 0 0 0 0 0 0 0 0 0 0 0 0 0 b 0 0 0 0 - - - 
- - - 0 0 0 0 0 0 0 0 0 0 0 0 0 0 0 0 0 0 0 0 0 0 0 0 0 0 0 - - - 
- - 0 0 - 0 0 0 0 0 0 0 0 0 0 0 0 0 0 0 0 0 0 0 0 0 0 0 - 0 0 - - 
- - - 0 0 0 0 0 0 0 0 0 0 0 0 0 0 0 0 0 0 0 0 0 0 0 0 0 0 0 - - - 
- - - 0 0 0 0 0 0 0 0 0 0 0 0 1 3 3 0 0 0 0 0 0 0 0 0 0 0 0 - - - 
- - - 0 0 - 0 0 0 0 0 0 0 0 0 3 1 2 0 0 0 0 0 0 0 0 0 - 0 0 - - - 
- - - 0 0 0 0 0 0 0 0 0 0 0 0 2 2 1 0 0 0 0 0 0 0 0 0 0 0 0 - - - 
- - - 0 0 0 0 0 0 0 0 0 0 0 0 0 0 0 0 0 0 0 0 0 0 0 0 0 0 0 - - - 
- - 0 0 - 0 0 0 0 0 0 0 0 0 0 0 0 0 0 0 0 0 0 0 0 0 0 0 - 0 0 - - 
- - - 0 0 0 0 0 0 0 0 0 0 0 0 0 0 0 0 0 0 0 0 0 0 0 0 0 0 0 - - - 
- - - 0 0 0 0 b 0 0 0 0 0 0 0 0 0 0 0 0 0 0 0 0 0 b 0 0 0 0 - - - 
- - - 0 0 - 0 b 0 0 0 0 0 0 0 b 0 b 0 0 0 0 0 0 0 b 0 - 0 0 - - - 
- - - 0 0 0 0 0 0 0 0 0 0 0 0 0 0 0 0 0 0 0 0 0 0 0 0 0 0 0 - - - 
- - - - - - - - - - - - - - - - - - - - - - - - - - - - - - - - - 
- - - - - - - - - - - - - - - c - c - - - - - - - - - - - - - - - 
- - - - - - - - - - - - - - - c - c - - - - - - - - - - - - - - - 
- - - - - c c c c c c c c c - c - c - c c c c c c c c c - - - - - 
- - - - - c - - - - - - - c - c - c - c - - - - - - - c - - - - - 
- - - - - c - c c c c c - c - c - c - c - c c c c c - c - - - - - 
- - - - - c - c - - - c - c - c - c - c - c - - - c - c - - - - - 
- - - - - c - c - 0 - c - c - c - c - c - c - 0 - c - c - - - - - 
- - - - - c - c - 0 - c - c - c - c - c - c - 0 - c - c - - - - - 
- - - - - c - c - - - - - c - c - c - c - - - - - c - c - - - - - 
- - - - - c - c c c c c c c - c - c - c c c c c c c - c - - - - - 
- - - - - c - - - - - - - - - c - c - - - - - - - - - c - - - - - 
- - - - - c c c c c c c c c c c - c c c c c c c c c c c - - - - - 
- - - - - - - - - - - - - - - - - - - - - - - - - - - - - - - - - 
0 - - - - - - - - - - - - - - - - - - - - - - - - - - - - - - - 0 
7 9 6 <-> 7 9 4
7 4 6 <-> 7 4 0
13 4 0 <-> 13 4 2
13 11 2 <-> 13 11 4
5 11 6 <-> 5 11 4
5 2 6 <-> 5 2 0
15 2 0 <-> 15 2 2
17 2 6 <-> 17 2 0
27 2 0 <-> 27 2 2
27 11 2 <-> 27 11 4
19 11 6 <-> 19 11 4
19 4 6 <-> 19 4 0
25 4 0 <-> 25 4 2
25 9 2 <-> 25 9 4
21 9 6 <-> 21 9 4
21 6 6 <-> 21 6 0
15 42 4 <-> 15 42 2
5 42 6 <-> 5 42 4
5 33 6 <-> 5 33 0
13 33 0 <-> 13 33 2
13 40 2 <-> 13 40 4
7 40 6 <-> 7 40 4
7 35 6 <-> 7 35 0
11 35 0 <-> 11 35 2
11 38 2 <-> 11 38 4
17 42 6 <-> 17 42 4
27 42 4 <-> 27 42 2
27 33 2 <-> 27 33 0
19 33 0 <-> 19 33 6
19 40 6 <-> 19 40 4
25 40 4 <-> 25 40 2
25 35 2 <-> 25 35 0
21 35 0 <-> 21 35 6
21 38 4 <-> 21 38 6
11 9 4 <-> 11 9 2
11 6 0 <-> 11 6 2
15 15 0 <-> 9 7 4
17 15 0 <-> 23 7 4
17 29 4 <-> 23 37 0
15 29 4 <-> 9 37 0
