3
3
1 1
21 21
0 0 0 0 0 0 0 - 0 0 c 0 0 - 0 0 0 0 0 0 0 
0 0 0 0 0 0 0 - - 0 0 0 - - 0 0 0 0 0 0 0 
0 0 1 2 3 0 0 0 - 0 0 0 - 0 0 0 2 1 3 0 0 
0 0 3 1 2 0 0 - - 0 0 0 - - 0 0 3 2 1 0 0 
0 0 2 3 1 0 0 - 0 0 0 0 0 - 0 0 1 3 2 0 0 
0 0 0 0 0 0 - 0 0 0 0 0 0 0 - 0 0 0 0 0 0 
0 0 0 0 0 - 0 0 0 0 0 0 0 0 0 - 0 0 0 0 0 
- - 0 - - 0 0 0 0 0 0 0 0 0 0 0 - - 0 - - 
0 - - - 0 0 0 0 0 0 0 0 0 0 0 0 0 - - - 0 
0 0 0 0 0 0 0 0 0 i 0 i 0 0 0 0 0 0 0 0 0 
c 0 0 0 0 0 0 0 0 0 b 0 0 0 0 0 0 0 0 0 c 
0 0 0 0 0 0 0 0 0 i 0 i 0 0 0 0 0 0 0 0 0 
0 - - - 0 0 0 0 0 0 0 0 0 0 0 0 0 - - - 0 
- - 0 - - 0 0 0 0 0 0 0 0 0 0 0 - - 0 - - 
0 0 0 0 0 - 0 0 0 0 0 0 0 0 0 - 0 0 0 0 0 
0 0 0 0 0 0 - 0 0 0 0 0 0 0 - 0 0 0 0 0 0 
0 0 3 1 2 0 0 - 0 0 0 0 0 - 0 0 3 1 2 0 0 
0 0 2 3 1 0 0 - - 0 0 0 - - 0 0 1 2 3 0 0 
0 0 1 2 3 0 0 0 - 0 0 0 - 0 0 0 2 3 1 0 0 
0 0 0 0 0 0 0 - - 0 0 0 - - 0 0 0 0 0 0 0 
0 0 0 0 0 0 0 - 0 0 c 0 0 - 0 0 0 0 0 0 0 
18 13 0 <-> 20 12 3
13 18 6 <-> 12 20 3
8 20 5 <-> 7 18 2
2 13 0 <-> 0 12 5
2 7 4 <-> 0 8 7
20 8 1 <-> 18 7 4
7 2 2 <-> 8 0 7
13 2 6 <-> 12 0 1
13 18 7 <-> 12 16 3
18 13 7 <-> 16 12 3
18 7 5 <-> 16 8 1
13 2 5 <-> 12 4 1
7 2 3 <-> 8 4 7
2 7 3 <-> 4 8 7
2 13 1 <-> 4 12 5
7 18 1 <-> 8 16 5
6 0 2 <-> 14 0 6
20 6 4 <-> 20 14 0
14 20 6 <-> 6 20 2
0 14 0 <-> 0 6 4
13 18 5 <-> 7 18 3
2 13 7 <-> 2 7 5
7 2 1 <-> 13 2 7
18 7 3 <-> 18 13 1
15 5 4 <-> 15 15 0
15 15 6 <-> 5 15 2
5 15 0 <-> 5 5 4
5 5 2 <-> 15 5 6
14 4 7 <-> 6 4 1
4 6 5 <-> 4 14 7
6 16 3 <-> 14 16 5
16 14 1 <-> 16 6 3
