3
0
0 0
13 13
0 0 0 0 0 - - - 0 0 0 0 0 
0 0 0 0 0 - - - 0 0 0 0 0 
0 0 x 0 0 - - - 0 0 x 0 0 
0 0 0 0 0 - - - 0 0 0 0 0 
0 0 0 0 0 0 0 0 0 0 0 0 0 
- - - - 0 1 2 3 0 - - - - 
- - - - 0 3 1 2 0 - - - - 
- - - - 0 2 3 1 0 - - - - 
0 0 0 0 0 0 0 0 0 0 0 0 0 
0 0 0 0 0 - - - 0 0 0 0 0 
0 0 x 0 0 - - - 0 0 x 0 0 
0 0 0 0 0 - - - 0 0 0 0 0 
0 0 0 0 0 - - - 0 0 0 0 0 
12 12 3 <-> 0 0 7
0 12 5 <-> 12 0 1
