3
5
2 2
35 35
- - - 0 0 0 0 0 0 0 0 0 0 0 0 0 x b x 0 0 0 0 0 0 0 0 0 0 0 0 0 - - - 
- i 0 0 0 0 0 0 0 0 0 0 0 0 0 0 - x - 0 0 0 0 0 0 0 0 0 0 0 0 0 0 i - 
- 0 0 0 0 0 0 0 0 0 0 0 0 0 - 0 0 0 0 0 - 0 0 0 0 0 0 0 0 0 0 0 0 0 - 
0 0 0 0 0 0 0 0 0 0 0 0 - 0 0 0 0 0 0 0 0 0 - 0 0 0 0 0 0 0 0 0 0 0 0 
0 0 0 0 0 0 0 0 0 0 0 0 0 0 0 0 0 0 0 0 0 0 0 0 0 0 0 0 0 0 0 0 0 0 0 
- 0 0 0 0 0 0 0 0 0 0 0 0 0 0 0 1 2 3 0 0 0 0 0 0 0 0 0 0 0 0 0 0 0 - 
b - 0 0 0 0 0 0 0 0 0 0 0 0 0 0 3 1 2 0 0 0 0 0 0 0 0 0 0 0 0 0 0 - b 
0 - 0 0 0 0 0 0 0 0 0 0 0 0 0 0 2 3 1 0 0 0 0 0 0 0 0 0 0 0 0 0 0 - 0 
0 - 0 0 0 0 0 0 0 0 0 0 0 0 0 0 0 0 0 0 0 0 0 0 0 0 0 0 0 0 0 0 0 - 0 
0 0 - 0 0 0 0 0 0 0 0 - - - - - - x - - - - - - 0 0 0 0 0 0 0 0 - 0 0 
0 0 0 - 0 0 0 0 0 0 0 0 0 0 0 0 0 - 0 0 0 0 0 0 0 0 0 0 0 0 0 - 0 0 0 
0 0 0 - 0 0 0 0 0 0 0 0 - 0 0 0 0 b 0 0 0 0 - 0 0 0 0 0 0 0 0 - 0 0 0 
0 0 0 - 0 0 0 0 0 0 0 0 0 0 0 0 0 - 0 0 0 0 0 0 0 0 0 0 0 0 0 - 0 0 0 
0 0 0 0 - 0 0 0 0 0 0 0 - - - - - - - - - - - 0 0 0 0 0 0 0 - 0 0 0 0 
0 0 0 0 0 - 0 0 0 0 0 0 0 0 0 0 0 - 0 0 0 0 0 0 0 0 0 0 0 - 0 0 0 0 0 
0 0 0 0 0 - 0 0 0 0 0 0 0 - 0 0 0 b 0 0 0 - 0 0 0 0 0 0 0 - 0 0 0 0 0 
0 0 0 0 0 - 0 0 0 0 0 0 0 0 0 0 0 - 0 0 0 0 0 0 0 0 0 0 0 - 0 0 0 0 0 
0 0 0 0 0 0 - 0 0 0 0 0 0 - - - - - - - - - 0 0 0 0 0 0 - 0 0 0 0 0 0 
0 0 0 0 0 0 0 - 0 0 0 0 0 0 0 0 0 - 0 0 0 0 0 0 0 0 0 - 0 0 0 0 0 0 0 
0 0 0 0 0 0 0 - 0 0 0 0 0 0 - 0 0 b 0 0 - 0 0 0 0 0 0 - 0 0 0 0 0 0 0 
0 0 0 0 0 0 0 - 0 0 0 0 0 0 0 0 0 - 0 0 0 0 0 0 0 0 0 - 0 0 0 0 0 0 0 
0 0 0 0 0 0 0 0 - 0 0 0 0 0 - - - - - - - 0 0 0 0 0 - 0 0 0 0 0 0 0 0 
0 0 0 0 0 0 0 0 0 - 0 0 0 0 0 0 0 - 0 0 0 0 0 0 0 - 0 0 0 0 0 0 0 0 0 
0 0 0 0 0 0 0 0 0 - 0 0 0 0 0 - 0 b 0 - 0 0 0 0 0 - 0 0 0 0 0 0 0 0 0 
0 0 0 3 1 2 0 0 0 - 0 0 0 0 0 0 0 - 0 0 0 0 0 0 0 - 0 0 0 2 3 1 0 0 0 
0 0 0 2 3 1 0 0 0 0 - 0 0 0 0 - - - - - 0 0 0 0 - 0 0 0 0 1 2 3 0 0 0 
0 0 0 1 2 3 0 0 0 0 0 - 0 0 0 0 0 - 0 0 0 0 0 - 0 0 0 0 0 3 1 2 0 0 0 
0 0 0 0 0 0 0 0 0 0 0 - 0 0 0 0 0 b 0 0 0 0 0 - 0 0 0 0 0 0 0 0 0 0 0 
0 0 0 0 0 0 0 0 0 0 0 - 0 0 0 0 0 - 0 0 0 0 0 - 0 0 0 0 0 0 0 0 0 0 0 
0 0 0 0 0 0 0 0 0 0 0 0 - x 0 0 - - - 0 0 x - 0 0 0 0 0 0 0 0 0 0 0 0 
0 0 0 0 0 0 0 0 0 0 0 0 0 0 0 0 0 - 0 0 0 0 0 0 0 0 0 0 0 0 0 0 0 0 0 
0 0 0 0 0 0 0 0 0 0 0 0 0 0 0 0 0 - 0 0 0 0 0 0 0 0 0 0 0 0 0 0 0 0 0 
0 0 c 0 0 0 0 0 0 0 0 0 0 0 0 0 0 b 0 0 0 0 0 0 0 0 0 0 0 0 0 0 c 0 0 
0 b 0 0 0 0 0 0 0 0 0 0 0 0 0 0 0 0 0 0 0 0 0 0 0 0 0 0 0 0 0 0 0 b 0 
- 0 0 0 0 0 0 0 0 0 0 0 0 0 0 0 0 0 0 0 0 0 0 0 0 0 0 0 0 0 0 0 0 0 - 
18 8 4 <-> 18 10 0
16 8 4 <-> 16 10 0
24 8 5 <-> 22 14 0
10 8 3 <-> 12 14 0
22 16 5 <-> 20 22 0
12 16 3 <-> 14 22 0
20 24 5 <-> 18 30 0
14 24 3 <-> 16 30 0
21 29 2 <-> 25 25 6
23 25 2 <-> 26 22 6
24 22 2 <-> 28 18 6
26 18 2 <-> 30 14 6
28 14 2 <-> 32 10 6
30 10 2 <-> 34 6 6
13 29 6 <-> 10 26 2
12 26 6 <-> 8 22 2
10 22 6 <-> 6 18 2
8 18 6 <-> 4 14 2
6 14 6 <-> 2 10 2
4 10 6 <-> 0 6 2
