3
8
0 1
29 34
- - - - - - - - - - - 0 0 0 - 0 - 0 - 0 - 0 - 0 - 0 - 0 - 0 0 - - - 
- - - - - - - - - - 0 0 0 0 0 0 0 0 0 0 0 0 0 0 0 0 0 0 0 0 0 0 - - 
- - - - - - - - - - 0 0 0 0 0 - 0 - 0 - 0 - 0 - 0 - 0 - 0 0 0 0 - - 
- - - - - - - - - - 0 b 0 - - - - - - - - - - - - - - - - 0 b 0 - - 
- - - - - - - - - - 0 0 0 - - 0 x 0 x 0 x 0 x 0 x 0 x - - 0 0 0 - - 
- - - - - - - - - 0 0 0 - - - x x 3 x x x 3 x x x 3 x - - - 0 0 0 - 
- - - - - - - - 0 0 0 - - - - x 3 x 3 x 3 x 3 x 3 x x - - - - 0 0 0 
- - - - - - - - 0 b 0 - - - - x x x x 3 x x x 3 x x x - - - - 0 b 0 
- - - - - - - - - 0 0 0 - - - x 0 x 0 x 0 x 0 x 0 x 0 - - - 0 0 0 - 
- - - - - - - - - - 0 0 0 - - - - - - - - - - - - - - - - 0 0 0 - - 
- - - - - - - - - - 0 b 0 - - - - - - - - - - - - - - - - 0 b 0 - - 
- - - - - - - - - 0 0 0 - - - - - - - - - - - - - - - - - - 0 0 0 - 
- - - - - - - - 0 0 0 - - - - 0 x 0 x 0 x 0 x 0 x 0 x - - - - 0 0 0 
- - - - - - - - 0 b 0 - - - - x x 2 x x x 2 x x x 2 x - - - - 0 b 0 
- - - - - - - - - 0 0 0 - - - x 2 x 2 x 2 x 2 x 2 x x - - - 0 0 0 - 
- - - - - - - - - - 0 0 0 - - x x x x 2 x x x 2 x x x - - 0 0 0 - - 
- - - - - - - - - - 0 b 0 - - x 0 x 0 x 0 x 0 x 0 x 0 - - 0 b 0 - - 
- - - - - - - - - 0 0 0 - - - - - - - - - - - - - - - - - - 0 0 0 - 
- - - - - - - - 0 0 0 - - - - - - - - - - - - - - - - - - - - 0 0 0 
- - - - - - - - 0 b 0 - - - - - - - - - - - - - - - - - - - - 0 b 0 
- - - - - - - - - 0 0 0 - - - 0 x 0 x 0 x 0 x 0 x 0 x - - - 0 0 0 - 
- - - - - - - - - - 0 0 0 - - x x 1 x x x 1 x x x 1 x - - 0 0 0 - - 
- - - - - - - - - - 0 b 0 - - x 1 x 1 x 1 x 1 x 1 x x - - 0 b 0 - - 
- - - - - - - - - 0 0 0 - - - x x x x 1 x x x 1 x x x - - - 0 0 0 - 
- - - - - - - - 0 0 0 - - - - x 0 x 0 x 0 x 0 x 0 x 0 - - - - 0 0 0 
- - - - - - - - 0 b 0 - - - - - - - - - - - - - - - - - - - - 0 b 0 
- - - - - - - - 0 0 0 0 0 - 0 - 0 - 0 - 0 - 0 - 0 - 0 - 0 0 0 0 0 0 
- - - - - - - - 0 0 0 0 0 0 0 0 0 0 0 0 0 0 0 0 0 0 0 0 0 0 0 0 0 - 
- - - - - - - - - 0 0 0 - 0 - 0 - 0 - 0 - 0 - 0 - 0 - 0 - 0 0 0 - - 
26 24 4 <-> 26 26 0
24 26 0 <-> 24 24 4
22 26 0 <-> 22 24 4
20 26 0 <-> 20 24 4
18 26 0 <-> 18 24 4
16 26 0 <-> 16 24 4
15 27 0 <-> 15 24 4
17 24 4 <-> 17 27 0
19 24 4 <-> 19 27 0
21 24 4 <-> 21 27 0
23 24 4 <-> 23 27 0
15 16 4 <-> 15 20 0
16 16 4 <-> 16 20 0
17 16 4 <-> 17 20 0
18 16 4 <-> 18 20 0
25 27 0 <-> 25 24 4
19 20 0 <-> 19 16 4
20 16 4 <-> 20 20 0
21 16 4 <-> 21 20 0
22 16 4 <-> 22 20 0
23 16 4 <-> 23 20 0
24 16 4 <-> 24 20 0
25 16 4 <-> 25 20 0
26 16 4 <-> 26 20 0
26 8 4 <-> 26 12 0
25 8 4 <-> 25 12 0
24 8 4 <-> 24 12 0
23 8 4 <-> 23 12 0
22 8 4 <-> 22 12 0
21 8 4 <-> 21 12 0
20 8 4 <-> 20 12 0
19 8 4 <-> 19 12 0
18 8 4 <-> 18 12 0
17 8 4 <-> 17 12 0
16 8 4 <-> 16 12 0
15 8 4 <-> 15 12 0
15 4 0 <-> 15 1 4
16 2 4 <-> 16 4 0
17 1 4 <-> 17 4 0
18 2 4 <-> 18 4 0
19 1 4 <-> 19 4 0
20 2 4 <-> 20 4 0
21 1 4 <-> 21 4 0
22 2 4 <-> 22 4 0
23 1 4 <-> 23 4 0
24 2 4 <-> 24 4 0
25 1 4 <-> 25 4 0
26 2 4 <-> 26 4 0
