3
8
2 3
23 24
- - - - 0 - - - - - - - - - - - - - - 0 - - - -
- - - 0 0 0 - - - - - - - - - - - - 0 0 0 - - -
- - 0 0 b 0 0 - - - - - - - - - - 0 0 b 0 0 - -
- - 0 0 0 0 0 - - - - - - - - - - 0 0 0 0 0 - -
- 0 0 0 0 0 0 0 - - - - - - - - 0 0 0 0 0 0 0 -
- 0 0 0 0 0 0 0 - - - - - - - - 0 0 0 0 0 0 0 -
- 0 0 0 0 0 0 0 - - - - - - - - 0 0 0 0 0 0 0 -
- 0 0 0 0 0 0 0 0 0 0 0 0 0 0 0 0 0 0 0 0 0 0 -
- 0 0 0 0 0 0 0 0 0 0 0 0 0 0 0 0 0 0 0 0 0 0 -
- 0 0 0 0 0 0 0 0 0 0 0 0 0 0 0 0 0 0 0 0 0 0 -
- 0 0 0 0 0 0 0 - - - - - - - - 0 0 0 0 0 0 0 -
- 0 0 0 0 0 0 0 - - - - - - - - 0 0 0 0 0 0 0 -
- 0 0 0 0 0 0 0 - - - - - - - - 0 0 0 0 0 0 0 -
- 0 0 0 0 0 0 0 - - - - - - - - 0 0 0 0 0 0 0 -
- 0 0 0 0 0 0 0 - - - - - - - - 0 0 0 0 0 0 0 -
- 0 0 0 0 0 0 0 - - - - - - - - 0 0 0 0 0 0 0 -
- 0 0 0 0 0 0 0 - - - - - - - - 0 0 0 0 0 0 0 -
- 0 0 1 2 3 0 0 - - - - - - - - 0 0 x x x 0 0 -
- 0 0 3 1 2 0 0 - - - - - - - - 0 0 x x x 0 0 -
- 0 0 2 3 1 0 0 - - - - - - - - 0 0 x x x 0 0 -
- 0 0 0 0 0 0 0 0 0 0 0 0 0 0 0 0 0 0 0 0 0 0 -
0 0 0 0 0 0 0 0 0 0 0 0 0 0 0 0 0 0 0 0 0 0 0 0
0 0 0 0 0 0 0 0 0 0 0 0 0 0 0 0 0 0 0 0 0 0 0 0
