3
2
5 2
19 43
- - - - - - - - - - - - - - - - - - - - - - - - - - - - - - - - - - - - - - - - - - - 
- x 0 0 i i i x 0 0 c c c x 0 0 b b b x 0 0 i i i x 0 0 c c c x 0 0 b b b x 0 0 i i i 
- 0 x 0 i i i 0 x 0 c c c 0 x 0 b b b 0 x 0 i i i 0 x 0 c c c 0 x 0 b b b 0 x 0 i i i 
- 0 0 x i i i 0 0 x c c c 0 0 x b b b 0 0 x i i i 0 0 x c c c 0 0 x b b b 0 0 x i i i 
- i i i x 0 0 c c c x 0 0 b b b 0 0 0 i i i 0 0 0 c c c x 0 0 b b b x 0 0 i i i x 0 0 
- i i i 0 x 0 c c c 0 x 0 b b b 0 0 0 i i i 0 0 0 c c c 0 x 0 b b b 0 x 0 i i i 0 x 0 
- i i i 0 0 x c c c 0 0 x b b b 0 0 0 i i i 0 0 0 c c c 0 0 x b b b 0 0 x i i i 0 0 x 
- x 0 0 c c c x 0 0 b b b x 0 0 i i i 2 1 3 c c c x 0 0 b b b x 0 0 i i i x 0 0 c c c 
- 0 x 0 c c c 0 x 0 b b b 0 x 0 i i i 3 2 1 c c c 0 x 0 b b b 0 x 0 i i i 0 x 0 c c c 
- 0 0 x c c c 0 0 x b b b 0 0 x i i i 1 3 2 c c c 0 0 x b b b 0 0 x i i i 0 0 x c c c 
- c c c x 0 0 b b b x 0 0 i i i 0 0 0 c c c 0 0 0 b b b x 0 0 i i i x 0 0 c c c x 0 0 
- c c c 0 x 0 b b b 0 x 0 i i i 0 0 0 c c c 0 0 0 b b b 0 x 0 i i i 0 x 0 c c c 0 x 0 
- c c c 0 0 x b b b 0 0 x i i i 0 0 0 c c c 0 0 0 b b b 0 0 x i i i 0 0 x c c c 0 0 x 
- x 0 0 b b b x 0 0 i i i x 0 0 c c c x 0 0 b b b x 0 0 i i i x 0 0 c c c x 0 0 b b b 
- 0 x 0 b b b 0 x 0 i i i 0 x 0 c c c 0 x 0 b b b 0 x 0 i i i 0 x 0 c c c 0 x 0 b b b 
- 0 0 x b b b 0 0 x i i i 0 0 x c c c 0 0 x b b b 0 0 x i i i 0 0 x c c c 0 0 x b b b 
- b b b x 0 0 i i i x 0 0 c c c x 0 0 b b b x 0 0 i i i x 0 0 c c c x 0 0 b b b x 0 0 
- b b b 0 x 0 i i i 0 x 0 c c c 0 x 0 b b b 0 x 0 i i i 0 x 0 c c c 0 x 0 b b b 0 x 0 
- b b b 0 0 x i i i 0 0 x c c c 0 0 x b b b 0 0 x i i i 0 0 x c c c 0 0 x b b b 0 0 x 
1 3 5 <-> 3 1 1
9 1 1 <-> 1 9 5
1 15 5 <-> 15 1 1
21 1 1 <-> 4 18 5
10 18 5 <-> 27 1 1
33 1 1 <-> 16 18 5
22 18 5 <-> 39 1 1
42 4 1 <-> 28 18 5
34 18 5 <-> 42 10 1
42 16 1 <-> 40 18 5
