3
6
3 2
40 37
- - - - - - - - - - - - - - - i - - - - - - - i - - - i - - - - - - - 0 0 
- - - - - - - - - - - - - - i - - - - - i - i - - - i - - - - - - 0 0 0 0 
- - - - - - - - - - - - - i - - i - - i - i - - - i - i - - - 0 0 0 b b 0 
- - - - - - - - - - - - - - - i - - i - - - - - - - i - - - 0 0 0 0 0 0 0 
- - - 0 0 0 0 0 0 - - - - - i - - - - - - - - - - i - - - 0 0 0 0 0 0 0 - 
- - - 0 0 0 b b 0 0 0 0 0 - - - - - - - - - - - - - - - 0 0 0 0 0 0 0 0 - 
- - - - - 0 0 0 0 0 0 0 0 0 0 0 0 - 0 0 0 0 0 0 0 - 0 0 0 0 0 0 0 0 0 - - 
- - - - - - 0 0 0 0 0 0 0 0 0 0 0 0 0 0 0 0 0 0 0 0 0 0 0 0 0 0 0 0 - - - 
- - - - - - - 0 0 0 0 0 0 0 0 0 0 3 1 0 0 0 0 0 0 0 0 0 0 0 0 0 0 - - - - 
- - - - - - - - 0 0 0 0 0 0 0 0 0 1 3 0 0 0 0 0 0 0 0 0 0 0 0 0 - - - - - 
- - - - - - - - - - 0 0 0 0 0 0 0 0 0 0 0 0 0 0 0 0 0 0 0 0 0 - - - - - - 
0 - - - - - - - - - - - 0 0 0 0 0 0 0 0 0 0 0 0 0 0 0 0 0 0 0 - - - - - - 
0 0 - - - - - - - - - - 0 0 0 0 - - 0 0 0 0 0 0 0 0 - - 0 0 0 - - - - - - 
0 0 0 - - - - - - - - 0 0 0 0 - - - - 0 0 0 0 0 0 - - - - 0 0 0 - - - - - 
0 x 0 0 - - - - - - - 0 0 0 0 - - - - 0 0 0 0 0 0 - - - - 0 0 0 - - - - - 
0 0 x 0 0 - - - - - - 0 0 0 0 0 - - 0 0 0 0 0 0 0 0 - - 0 0 0 0 - - - - - 
0 0 0 x 0 0 - - - - 0 0 0 0 0 0 0 0 0 0 0 - - 0 0 0 0 0 0 0 0 0 0 - - - - 
0 0 0 0 x 0 0 - - - 0 0 0 0 0 0 0 0 0 0 0 0 0 0 0 0 0 0 0 0 0 0 0 - - - - 
0 x 0 0 0 0 0 0 - - 0 0 0 0 0 0 0 0 - 0 0 - - 0 0 - 0 0 0 0 0 0 0 - - - - 
0 0 x 0 0 0 0 0 0 - 0 0 0 0 0 0 0 0 0 - - 0 0 - - 0 0 0 0 0 0 0 0 - - - - 
0 0 0 x 0 0 0 0 0 0 0 0 0 0 0 0 0 0 0 0 0 0 0 0 0 0 0 0 0 0 0 0 - - - - - 
0 0 0 0 x 0 0 0 0 0 0 0 0 0 0 0 0 0 0 0 0 0 0 0 0 0 2 3 0 0 0 0 - - - - - 
- 0 0 0 0 0 0 0 0 0 0 0 0 0 0 0 0 0 0 0 0 0 0 0 0 0 3 2 0 0 0 - - - - - - 
- - 0 0 0 0 0 0 0 b - 0 0 0 0 0 0 0 0 0 0 0 0 0 0 0 0 0 0 0 0 0 - - - - - 
- - - 0 0 0 0 0 b - - - 0 0 0 0 0 0 0 0 0 0 0 0 0 0 0 0 0 0 0 0 - - - - - 
- - 0 0 0 0 0 0 - - - - 0 0 0 0 0 0 0 0 0 0 0 0 0 0 0 0 0 0 0 0 - - - - - 
- - 0 0 0 0 0 0 0 - - 0 0 0 0 0 0 0 0 - 0 0 0 0 0 0 - 0 0 0 0 0 - - - - - 
- - - 0 0 0 0 0 0 0 - 0 0 0 0 - 0 0 0 - 0 0 0 0 0 0 - 0 0 0 - 0 0 - - - - 
- - - - 0 0 0 0 0 0 0 0 0 0 0 - 0 0 0 0 - 0 0 0 0 - 0 0 0 0 - 0 0 - - - - 
- - - - - 0 0 0 0 0 0 0 0 0 0 0 - 0 0 0 - 0 0 0 0 - 0 0 0 - 0 0 0 - - - - 
- - - - - - 0 0 0 0 0 0 0 0 0 0 - 0 0 0 - 0 0 0 0 - 0 0 0 - 0 0 0 - - - - 
- - - - - 0 0 0 0 0 0 0 0 0 0 0 0 - b b - 0 0 0 0 - b b - 0 0 0 0 - - - - 
- - - - - - 0 0 0 0 0 0 0 0 0 0 0 0 - - 0 0 0 0 0 0 - - 0 0 0 0 0 - - - - 
- - - - - - - 0 0 0 0 0 0 0 0 0 0 0 0 0 0 0 0 0 0 0 0 0 0 0 0 0 0 - - - - 
- - - - - - - - - 0 0 0 0 0 0 2 1 0 0 0 0 0 0 0 0 0 0 0 0 0 0 0 - - - - - 
- - - - - - - - - - - 0 0 0 0 1 2 0 0 0 0 0 0 0 0 0 0 0 0 0 0 0 - - - - - 
- - - - - - - - - - - - 0 0 0 0 0 0 0 0 0 0 0 0 0 0 0 0 0 0 0 - - - - - - 
- - - - - - - - - - - - - 0 0 0 0 0 0 0 0 0 0 0 0 0 0 0 0 0 - - - - - - - 
- - - - - - - - - - - - 0 0 0 0 0 0 0 - - - - - - 0 0 0 0 0 0 - - - - - - 
- - - - - - - - - - - - 0 0 0 0 0 - - - - - - - - - 0 0 0 0 0 - - - - - - 
27 39 4 <-> 36 0 2
28 39 4 <-> 36 1 2
29 39 4 <-> 36 2 2
30 39 4 <-> 36 3 2
12 39 4 <-> 8 4 0
13 39 4 <-> 7 4 0
14 39 4 <-> 6 4 0
15 39 4 <-> 5 4 0
0 12 6 <-> 19 6 0
0 20 6 <-> 23 6 0
0 16 6 <-> 21 6 0
32 17 2 <-> 12 24 6
32 18 2 <-> 12 25 6
