3
3
5 1
39 39
0 0 0 - 0 0 0 0 0 0 0 0 0 0 0 - 0 0 0 0 0 0 0 0 0 0 0 - 0 0 0 0 0 0 0 - b b b
0 0 0 - 0 0 0 0 0 0 0 0 0 0 0 - 0 0 0 0 0 0 0 0 0 c 0 - 0 0 0 0 0 0 0 - 0 0 0
0 0 0 - 0 0 0 0 0 0 0 0 0 0 0 - 0 0 0 0 0 0 0 0 0 0 0 - 0 0 0 0 0 0 0 - 0 0 0
0 0 0 - 0 0 0 - 0 0 0 - 0 0 0 - 0 0 0 - - - - - 0 0 0 - 0 0 0 - 0 0 0 - 0 0 0
0 0 0 0 0 0 0 - 0 0 0 - 1 2 3 0 0 0 0 - 0 0 0 0 0 0 0 - 0 0 0 - 0 0 0 0 0 0 0
0 c 0 0 0 0 0 - 0 0 0 - 2 3 1 0 0 0 0 - 0 0 0 0 0 0 0 - 0 0 0 - 0 0 0 0 0 0 0
0 0 0 0 0 0 0 - 0 0 0 - 3 1 2 0 0 0 0 - 0 0 0 0 0 0 0 - 0 0 0 - 0 0 0 0 0 0 0
- - - - - - - - 0 0 0 - - - - - - - - - 0 0 0 - - - - - 0 0 0 - - - - - - - -
0 0 0 0 0 0 0 - x x x 0 0 0 0 0 0 0 0 - 0 0 0 0 0 0 0 - 0 0 0 0 0 0 0 0 0 0 0
0 c 0 0 0 0 0 - x x x 0 0 i 0 0 0 0 0 - 0 i 0 0 0 0 0 - 0 0 0 0 0 0 0 0 0 0 0
0 0 0 0 0 0 0 - x x x 0 0 0 0 0 0 0 0 - 0 0 0 0 0 0 0 - 0 0 0 0 0 0 0 0 0 0 0
0 0 0 - 0 0 0 - - - - - 0 0 0 - - - - - 0 0 0 - 0 0 0 - - - - - - - - - 0 0 0
0 0 0 - 0 0 0 0 0 0 0 0 0 0 0 - 0 0 0 0 0 0 0 - 0 0 0 0 0 0 0 0 0 0 0 0 0 0 0
0 0 0 - 0 0 0 0 0 i 0 0 0 0 0 - 0 0 0 0 0 0 0 - 0 0 0 0 0 0 0 0 0 0 0 0 0 i 0
0 0 0 - 0 0 0 0 0 0 0 0 0 0 0 - 0 0 0 0 0 0 0 - 0 0 0 0 0 0 0 0 0 0 0 0 0 0 0
0 0 0 - - - - - 0 0 0 - - - - - 0 0 0 - 0 0 0 - - - - - - - - - - - - - 0 0 0
x x x - b 0 0 0 0 0 0 - 0 0 0 0 0 0 0 - 0 0 0 - 0 0 0 0 0 0 0 0 0 0 0 0 0 0 0
x x x - b 0 0 0 0 0 0 - 0 0 0 0 0 c 0 - 0 0 0 - 0 0 0 0 0 0 0 0 0 0 0 0 0 0 0
x x x - b 0 0 0 0 0 0 - 0 0 0 0 0 0 0 - 0 0 0 - 0 0 0 0 0 0 0 0 0 0 0 0 0 0 0
0 0 0 - - - - - - - - - 0 0 0 - - - - - 0 0 0 - 0 0 0 - - - - - 0 0 0 - - - -
0 0 0 - x x x 0 0 0 0 0 0 0 0 - 0 0 0 - 0 0 0 0 0 0 0 - x x x 0 0 0 0 - 0 0 0
0 0 0 - x x x 0 0 0 0 0 0 0 0 - b b b - 0 0 0 0 0 0 0 - x x x 0 0 c 0 - b b b
0 0 0 - x x x 0 0 0 0 0 0 0 0 - 0 0 0 - 0 0 0 0 0 0 0 - x x x 0 0 0 0 - 0 0 0
0 0 0 - 0 0 0 - - - - - - - - - 0 0 0 - - - - - - - - - 0 0 0 - 0 0 0 - 0 0 0
0 0 0 - 0 0 0 0 0 0 0 - 0 0 0 0 0 0 0 - 0 0 0 0 0 0 0 0 0 0 0 - 0 0 0 0 0 0 0
0 0 0 - 0 c 0 0 0 0 0 - 0 0 0 0 0 i 0 - 0 0 0 0 0 i 0 0 0 0 0 - 0 0 0 0 0 i 0
0 0 0 - 0 0 0 0 0 0 0 - 0 0 0 0 0 0 0 - 0 0 0 0 0 0 0 0 0 0 0 - 0 0 0 0 0 0 0
0 0 0 - - - - - 0 0 0 - 0 0 0 - 0 0 0 - - - - - 0 0 0 - - - - - - - - - 0 0 0
0 0 0 0 0 0 0 - 0 0 0 - 0 0 0 - 0 0 0 0 0 0 0 - 0 0 0 0 0 0 0 - 0 0 0 - 0 0 0
0 i 0 0 0 0 0 - 0 0 0 - 0 0 0 - 0 0 0 0 0 c 0 - 0 0 0 0 0 0 0 - 0 0 0 - 0 0 0
0 0 0 0 0 0 0 - 0 0 0 - 0 0 0 - 0 0 0 0 0 0 0 - 0 0 0 0 0 0 0 - 0 0 0 - 0 0 0
0 0 0 - 0 0 0 - 0 0 0 - 0 0 0 - - - - - 0 0 0 - 0 0 0 - 0 0 0 - 0 0 0 - 0 0 0
0 0 0 - 0 0 0 - 0 0 0 0 0 0 0 - 0 0 0 - 0 0 0 - 0 0 0 - 0 0 0 - 0 0 0 - 0 0 0
0 0 0 - 0 0 0 - 0 0 0 0 0 0 0 - 0 0 0 - 0 0 0 - 0 0 0 - 0 0 0 - 0 0 0 - 0 0 0
0 0 0 - 0 0 0 - 0 0 0 0 0 0 0 - 0 0 0 - 0 0 0 - 0 0 0 - 0 0 0 - 0 0 0 - 0 0 0
0 0 0 - 0 0 0 - - - - - - - - - 0 0 0 - 0 0 0 - - - - - 0 0 0 - 0 0 0 - 0 0 0
0 0 0 - 0 0 0 0 0 0 0 0 0 0 0 0 1 2 3 0 0 0 0 0 0 0 0 0 0 0 0 - 0 0 0 0 x x x
0 0 0 - 0 c 0 0 0 0 0 0 0 0 0 0 2 3 1 0 0 0 0 0 0 0 0 0 0 0 0 - 0 c 0 0 x x x
b b b - 0 0 0 0 0 0 0 0 0 0 0 0 3 1 2 0 0 0 0 0 0 0 0 0 0 0 0 - 0 0 0 0 x x x 