3
1
1 2
19 25
- - - - - - - - - - - - - - - - - - - - - - - - - 
- - - - - - - - 0 0 0 0 0 0 0 0 0 - - - - - - - - 
- - - - 0 0 0 0 0 0 0 0 0 0 0 0 0 0 0 0 0 - - - - 
- - - 0 0 0 0 0 0 - - - - - - - 0 0 0 0 0 0 - - - 
- - 0 0 - - - - - - - - - - - - - - - - - 0 0 - - 
- - 0 - - - - - - - - - - - - - - - - - - - 0 - - 
- - - - - - - - - - - - - - - - - - - - - - - - - 
- - - - - - - - - 0 0 0 c 0 0 0 - - - - - - - - - 
- - - - - - - b 0 0 0 0 0 0 0 0 0 b - - - - - - - 
- - - - - b 0 0 0 0 x x x x x 0 0 0 0 b - - - - - 
- - - - 0 0 0 0 0 x 0 0 0 0 0 x 0 0 0 0 0 - - - - 
- - - 0 0 0 0 0 x 0 0 2 3 1 0 0 x 0 0 0 0 0 - - - 
- - 0 0 0 0 0 0 x 0 0 1 2 3 0 0 x 0 0 0 0 0 0 - - 
- - - 0 0 0 0 0 x 0 0 3 1 2 0 0 x 0 0 0 0 0 - - - 
- - - - 0 0 0 0 0 x 0 0 0 0 0 x 0 0 0 0 0 - - - - 
- - - - - 0 0 0 0 0 x x x x x 0 0 0 0 0 - - - - - 
- - - - - - - 0 0 0 0 0 0 0 0 0 0 0 - - - - - - - 
- - - - - - - - - 0 0 0 0 0 0 0 - - - - - - - - - 
- - - - - - - - - - - - - - - - - - - - - - - - - 
4 10 0 <-> 4 3 4
20 10 0 <-> 20 3 4
10 7 0 <-> 10 2 4
14 7 0 <-> 14 2 4
2 12 0 <-> 2 5 4
22 12 0 <-> 22 5 4
