3
1
2 3
43 43
- - - - - - - - - - - - - - - - 0 0 0 0 - - - 0 0 0 0 - - - - - - - - - - - - - - - - 
- - - - - - - - - - - - - 0 0 0 0 0 0 0 - - - 0 0 0 0 0 0 0 - - - - - - - - - - - - - 
- - - - - - - - - - - 0 0 0 0 0 0 0 0 0 - - - 0 0 0 0 0 0 0 0 0 - - - - - - - - - - - 
- - - - - - - - - 0 0 0 0 0 0 0 0 0 0 0 - - - 0 0 0 0 0 0 0 0 0 0 0 - - - - - - - - - 
- - - - - - - - 0 0 0 0 0 0 0 0 0 0 0 0 - - - 0 0 0 0 0 0 0 0 0 0 0 0 - - - - - - - - 
- - - - - - 0 0 0 0 0 0 0 0 0 0 0 0 0 0 - - - 0 0 0 0 0 0 0 0 0 0 0 0 0 0 - - - - - - 
- - - - - 0 0 0 0 0 0 0 0 0 0 0 0 0 0 0 - - - 0 0 0 0 0 0 0 0 0 0 0 0 0 0 0 - - - - - 
- - - - - 0 0 0 0 0 0 0 0 0 0 0 0 0 0 0 - - - 0 0 0 0 0 0 0 0 0 0 0 0 0 0 0 - - - - - 
- - - - 0 0 0 0 0 0 0 0 0 0 0 0 0 0 0 0 - - - 0 0 0 0 0 0 0 0 0 0 0 0 0 0 0 0 - - - - 
- - - 0 0 0 0 0 0 0 0 0 0 0 0 0 0 0 0 0 - - - 0 0 0 0 0 0 0 0 0 0 0 0 0 0 0 0 0 - - - 
- - - 0 0 0 0 0 0 0 0 0 0 0 0 0 0 0 0 0 - - - 0 0 0 0 0 0 0 0 0 0 0 0 0 0 0 0 0 - - - 
- - 0 0 0 0 0 0 0 0 0 0 0 0 0 0 0 0 0 0 - - - 0 0 0 0 0 0 0 0 0 0 0 0 0 0 0 0 0 0 - - 
- - 0 0 0 0 0 0 0 0 0 0 0 0 0 0 0 0 0 0 - - - 0 0 0 0 0 0 0 0 0 0 0 0 0 0 0 0 0 0 - - 
- 0 0 0 0 0 0 0 0 0 0 0 0 0 0 0 0 0 0 0 - - - 0 0 0 0 0 0 0 0 0 0 0 0 0 0 0 0 0 0 0 - 
- 0 0 0 0 0 0 0 0 0 0 0 0 0 0 0 0 0 0 0 - - - 0 0 0 0 0 0 0 0 0 0 0 0 0 0 0 0 0 0 0 - 
- 0 0 0 0 0 0 0 0 0 0 0 0 0 0 0 0 0 0 0 - - - 0 0 0 0 0 0 0 0 0 0 0 0 0 0 0 0 0 0 0 - 
0 0 0 0 0 0 0 0 0 1 2 3 0 0 0 0 0 0 0 0 - - - 0 0 0 0 0 0 0 0 1 2 3 0 0 0 0 0 0 0 0 0 
0 0 0 0 0 0 0 0 0 2 3 1 0 0 0 0 0 0 0 0 - - - 0 0 0 0 0 0 0 0 2 3 1 0 0 0 0 0 0 0 0 0 
0 0 0 0 0 0 0 0 0 3 1 2 0 0 0 0 0 0 0 0 - - - 0 0 0 0 0 0 0 0 3 1 2 0 0 0 0 0 0 0 0 0 
0 0 0 0 0 0 0 0 0 0 0 0 0 0 0 0 0 0 0 0 - - - 0 0 0 0 0 0 0 0 0 0 0 0 0 0 0 0 0 0 0 0 
0 0 0 0 0 0 0 0 0 0 0 0 0 0 0 0 0 0 0 0 - - - 0 0 0 0 0 0 0 0 0 0 0 0 0 0 0 0 0 0 0 0 
0 0 0 0 0 0 0 0 0 0 0 0 0 0 0 0 0 0 0 0 - - - 0 0 0 0 0 0 0 0 0 0 0 0 0 0 0 0 0 0 0 0 
0 0 0 0 0 0 0 0 0 0 0 0 0 0 0 0 0 0 0 - - 0 - - 0 0 0 0 0 0 0 0 0 0 0 0 0 0 0 0 0 0 0 
0 0 0 0 0 0 0 0 0 0 0 0 0 0 0 0 0 0 - - - c - - - 0 0 0 0 0 0 0 0 0 0 0 0 0 0 0 0 0 0 
0 0 0 0 0 0 0 0 0 0 0 0 0 0 0 0 0 - - - - 0 - - - - 0 0 0 0 0 0 0 0 0 0 0 0 0 0 0 0 0 
0 0 0 0 0 0 0 0 0 0 0 0 0 0 0 0 - - - 0 - - - 0 - - - 0 0 0 0 0 0 0 0 0 0 0 0 0 0 0 0 
0 0 0 0 0 0 0 0 0 0 0 0 0 0 0 - - - 0 0 - - - 0 0 - - - 0 0 0 0 0 0 0 0 0 0 0 0 0 0 0 
- 0 0 0 0 0 0 0 0 0 0 0 0 0 - - - 0 0 0 - - - 0 0 0 - - - 0 0 0 0 0 0 0 0 0 0 0 0 0 - 
- 0 0 0 0 0 0 0 0 0 0 0 0 - - - 0 0 0 0 - - - 0 0 0 0 - - - 0 0 0 0 0 0 0 0 0 0 0 0 - 
- 0 0 0 0 0 0 0 0 0 0 0 - - - 0 0 0 0 0 - - - 0 0 0 0 0 - - - 0 0 0 0 0 0 0 0 0 0 0 - 
- - 0 0 0 0 0 0 0 0 0 - - - 0 0 0 0 0 0 - - - 0 0 0 0 0 0 - - - 0 0 0 0 0 0 0 0 0 - - 
- - 0 0 0 0 0 0 0 0 - - - 0 0 0 0 0 0 0 - - - 0 0 0 0 0 0 0 - - - 0 0 0 0 0 0 0 0 - - 
- - - 0 0 0 0 0 0 - - - 0 0 0 0 0 0 0 0 - - - 0 0 0 0 0 0 0 0 - - - 0 0 0 0 0 0 - - - 
- - - 0 0 0 0 0 - - - 0 0 0 0 0 0 0 0 0 - - - 0 0 0 0 0 0 0 0 0 - - - 0 0 0 0 0 - - - 
- - - - 0 0 0 - - - 0 0 0 0 0 0 0 0 0 0 - - - 0 0 0 0 0 0 0 0 0 0 - - - 0 0 0 - - - - 
- - - - - 0 - - - 0 0 0 0 0 0 b 0 0 0 0 - - - 0 0 0 0 b 0 0 0 0 0 0 - - - 0 - - - - - 
- - - - - - - - 0 0 0 0 0 0 0 0 0 0 0 0 - - - 0 0 0 0 0 0 0 0 0 0 0 0 - - - - - - - - 
- - - - - - - 0 0 0 0 0 0 0 0 0 0 0 0 0 - - - 0 0 0 0 0 0 0 0 0 0 0 0 0 - - - - - - - 
- - - - - - - 0 0 0 0 0 0 0 0 0 0 0 0 0 - - - 0 0 0 0 0 0 0 0 0 0 0 0 0 - - - - - - - 
- - - - - - - - - 0 0 0 0 0 0 0 0 0 0 0 - - - 0 0 0 0 0 0 0 0 0 0 0 - - - - - - - - - 
- - - - - - - - - - - 0 0 0 0 0 0 0 0 0 - - - 0 0 0 0 0 0 0 0 0 - - - - - - - - - - - 
- - - - - - - - - - - - - 0 0 0 0 0 0 0 - - - 0 0 0 0 0 0 0 - - - - - - - - - - - - - 
- - - - - - - - - - - - - - - - 0 0 0 0 - - - 0 0 0 0 - - - - - - - - - - - - - - - - 
19 17 2 <-> 23 17 6
21 22 0 <-> 19 4 2
21 24 4 <-> 23 4 6
14 30 6 <-> 12 28 2
28 30 2 <-> 30 28 6
19 40 2 <-> 23 40 6
12 28 4 <-> 14 30 0
12 28 3 <-> 14 30 7
30 28 4 <-> 28 30 0
28 30 1 <-> 30 28 5
19 16 2 <-> 23 16 6
