3
4
4 2
35 35
0 0 0 0 0 0 0 0 0 0 0 0 0 0 0 - - 0 - - 0 0 0 0 0 0 0 0 0 0 0 0 0 0 0 
0 0 0 0 0 0 0 0 0 0 0 0 0 0 - - 0 0 0 - - 0 0 0 0 0 0 0 0 0 0 0 0 0 0 
0 0 1 2 0 0 0 0 0 0 0 0 0 - - 0 0 0 0 0 - - 0 0 0 0 0 0 0 0 1 3 2 0 0 
0 0 2 1 0 0 0 0 0 0 0 0 - - 0 0 0 0 0 0 0 - - 0 0 0 0 0 0 0 2 1 3 0 0 
0 0 0 0 0 0 0 0 0 0 0 - - 0 0 0 0 0 0 0 0 0 - - 0 0 0 0 0 0 3 2 1 0 0 
0 0 0 0 0 0 0 0 0 0 - - 0 0 0 0 0 - 0 0 0 0 0 - - 0 0 0 0 0 0 0 0 0 0 
0 0 0 0 0 0 0 0 0 - - 0 0 0 0 0 - - - 0 0 0 0 0 - - 0 0 0 0 0 0 0 0 0 
0 0 0 0 0 0 0 0 - - 0 0 0 0 0 - - 0 - - 0 0 0 0 0 - - 0 0 0 0 0 0 0 0 
0 0 0 0 0 0 0 - - 0 0 i 0 0 - - 0 0 0 - - 0 0 i 0 0 - - 0 0 0 0 0 0 0 
0 0 0 0 0 0 - - 0 0 c 0 0 - - 0 0 0 0 0 - - 0 0 c 0 0 - - 0 0 0 0 0 0 
0 0 0 0 0 - - 0 0 b 0 0 - - 0 0 0 0 0 0 0 - - 0 0 b 0 0 - - 0 0 0 0 0 
0 0 0 0 - - 0 0 c 0 0 - - 0 0 0 0 0 0 0 0 0 - - 0 0 c 0 0 - - 0 0 0 0 
0 0 0 - - 0 0 i 0 0 - - 0 0 0 0 0 - 0 0 0 0 0 - - 0 0 i 0 0 - - 0 0 0 
0 0 - - 0 0 0 0 0 - - 0 0 0 0 0 - - - 0 0 0 0 0 - - 0 0 0 0 0 - - 0 0 
0 - - 0 0 0 0 0 - - 0 0 0 0 0 - - 0 - - 0 0 0 0 0 - - 0 0 0 0 0 - - 0 
- - 0 0 0 0 0 - - 0 0 0 0 0 - - 0 0 0 - - 0 0 0 0 0 - - 0 0 0 0 0 - - 
- 0 0 0 0 0 - - 0 0 0 0 0 - - 0 0 x 0 0 - - 0 0 0 0 0 - - 0 0 0 0 0 - 
0 0 0 0 0 - - 0 0 0 0 0 - - 0 0 x x x 0 0 - - 0 0 0 0 0 - - 0 0 0 0 0 
- 0 0 0 0 0 - - 0 0 0 0 0 - - 0 0 x 0 0 - - 0 0 0 0 0 - - 0 0 0 0 0 - 
- - 0 0 0 0 0 - - 0 0 0 0 0 - - 0 0 0 - - 0 0 0 0 0 - - 0 0 0 0 0 - - 
0 - - 0 0 0 0 0 - - 0 0 0 0 0 - - 0 - - 0 0 0 0 0 - - 0 0 0 0 0 - - 0 
0 0 - - 0 0 0 0 0 - - 0 0 0 0 0 - - - 0 0 0 0 0 - - 0 0 0 0 0 - - 0 0 
0 0 0 - - 0 0 i 0 0 - - 0 0 0 0 0 - 0 0 0 0 0 - - 0 0 i 0 0 - - 0 0 0 
0 0 0 0 - - 0 0 c 0 0 - - 0 0 0 0 0 0 0 0 0 - - 0 0 c 0 0 - - 0 0 0 0 
0 0 0 0 0 - - 0 0 b 0 0 - - 0 0 0 0 0 0 0 - - 0 0 b 0 0 - - 0 0 0 0 0 
0 0 0 0 0 0 - - 0 0 c 0 0 - - 0 0 0 0 0 - - 0 0 c 0 0 - - 0 0 0 0 0 0 
0 0 0 0 0 0 0 - - 0 0 i 0 0 - - 0 0 0 - - 0 0 i 0 0 - - 0 0 0 0 0 0 0 
0 0 0 0 0 0 0 0 - - 0 0 0 0 0 - - 0 - - 0 0 0 0 0 - - 0 0 0 0 0 0 0 0 
0 0 0 0 0 0 0 0 0 - - 0 0 0 0 0 - - - 0 0 0 0 0 - - 0 0 0 0 0 0 0 0 0 
0 0 0 0 0 0 0 0 0 0 - - 0 0 0 0 0 - 0 0 0 0 0 - - 0 0 0 0 0 0 0 0 0 0 
0 0 0 0 0 0 0 0 0 0 0 - - 0 0 0 0 0 0 0 0 0 - - 0 0 0 0 0 0 0 0 0 0 0 
0 0 3 2 0 0 0 0 0 0 0 0 - - 0 0 0 0 0 0 0 - - 0 0 0 0 0 0 0 0 3 1 0 0 
0 0 2 3 0 0 0 0 0 0 0 0 0 - - 0 0 0 0 0 - - 0 0 0 0 0 0 0 0 0 1 3 0 0 
0 0 0 0 0 0 0 0 0 0 0 0 0 0 - - 0 0 0 - - 0 0 0 0 0 0 0 0 0 0 0 0 0 0 
0 0 0 0 0 0 0 0 0 0 0 0 0 0 0 - - 0 - - 0 0 0 0 0 0 0 0 0 0 0 0 0 0 0 
14 0 2 <-> 34 17 1
20 0 6 <-> 17 34 3
20 34 6 <-> 0 17 5
14 34 2 <-> 17 0 7
0 14 5 <-> 0 17 6
0 20 7 <-> 17 34 4
34 20 1 <-> 34 17 2
34 14 3 <-> 17 0 0
17 4 4 <-> 17 27 4
30 17 6 <-> 7 17 6
4 17 2 <-> 27 17 2
17 30 0 <-> 17 7 0
27 7 5 <-> 22 22 4
27 27 7 <-> 12 22 4
7 27 1 <-> 12 12 0
7 7 3 <-> 22 12 0
14 17 6 <-> 11 17 2
17 14 0 <-> 17 11 4
20 17 2 <-> 23 17 6
17 20 4 <-> 17 23 0
