3
0
0 1
25 49
- - - - - - - - - - - - - - - - - - - - - - - - - - - - - - - - - - - - - - - - - - - - - - - - -
- - - - - - - - - - - - - - - - - 0 0 0 - - - - - - - - - - - - - - - 0 - - - - - - - - - - - - -
- - - - - - - - - - - - 0 0 0 0 0 0 0 0 0 - - - - - - - - - - - - - - - 0 0 - - - - - - - - - - -
- - - - - - - - - - - 0 - 0 0 0 0 0 0 0 - - - - - - - - - - - - - 0 0 0 0 0 0 0 - - - - - - - - -
- - - - - - - 0 0 0 - 0 0 0 - - 0 0 0 - - - - - - - 0 0 - - - - 0 0 0 0 0 0 0 0 0 0 0 0 0 - - - -
- - 0 0 0 0 0 0 0 0 0 0 - 0 0 - - 0 0 - - - - - - 0 0 0 0 - - 0 0 0 0 0 0 0 0 0 0 0 0 0 0 0 0 - -
- - 0 0 0 0 0 0 0 0 0 0 - - 0 - - 0 - - - - - - - 0 0 - 0 0 0 0 0 0 0 0 0 0 0 0 0 0 0 0 0 0 0 0 -
- 0 - - - 0 0 0 0 0 0 - - 0 0 - - - - - - - - b - - - 0 0 0 0 0 0 0 0 0 0 0 0 0 0 0 0 0 - 0 - - -
- - - - - 0 0 0 0 0 0 0 - 0 0 0 - - - - - - - - b 1 b 2 b 3 0 0 0 0 0 0 0 0 0 0 0 0 0 - - 0 - - -
- - - - - - 0 0 0 0 0 0 0 0 0 - - - - - - - 0 0 1 2 3 2 0 0 0 0 0 0 0 0 0 0 0 0 0 0 - - 0 - - - -
- - - - - - 0 0 0 1 3 1 0 b - - - - - - - - 0 0 - b - 0 - - 0 0 0 0 0 0 0 0 0 b b - - - - - - - -
- - - - - - - 0 0 3 1 3 0 - - - - - - - - - - - - - 0 - b 0 b 0 0 b 0 0 0 3 1 3 - - 0 - - - - - -
- - - - - - - - 0 0 - - 0 - - - - - - - - - 0 0 0 - - - 0 0 - 0 0 0 b 0 0 1 3 1 - b - - - - - - -
- - - - - - - - - 0 0 - - - - - - - - - - 0 0 0 0 0 0 b - 0 0 - - 0 0 0 0 0 0 - - - - - - - - - -
- - - - - - - - - - 0 0 - - - - - - - - - 0 0 0 0 0 0 0 - - - - - 0 0 - - 0 0 - 0 - - - - - - - -
- - - - - - - - - - - 0 0 0 0 - - - - - - 0 0 0 0 0 0 0 0 0 - - - - 0 - - 0 0 - - - - - - - - - -
- - - - - - - - - - - 0 0 0 0 0 - - - - - - 0 0 0 0 0 0 0 - - - - - - - - - b 0 - - - - - - - - -
- - - - - - - - - - - 0 0 0 0 0 0 0 - - - - - - 0 0 0 0 0 - - - - - - - - - - - - - - - - - - - -
- - - - - - - - - - - - 0 0 0 b 0 - - - - - - - - 0 0 0 0 - - - - - - - - - - - 0 0 0 - - - - - -
- - - - - - - - - - - - - 0 0 0 0 - - - - - - - - 0 0 0 - - - - - - - - - - - 0 0 0 0 - - - - - -
- - - - - - - - - - - - - 0 0 0 - - - - - - - - - 0 0 0 - - - - - - - - - - 0 0 0 0 0 0 - - - - -
- - - - - - - - - - - - - 0 0 - - - - - - - - - - - 0 - - - - - - - - - - - 0 0 0 0 0 0 - - - - -
- - - - - - - - - - - - 0 0 - - - - - - - - - - - - - - - - - - - - - - - - - - - 0 0 - - - - - -
- - - - - - - - - - - - 0 - - - - - - - - - - - - - - - - - - - - - - - - - - - - - - - - - - - -
- - - - - - - - - - - - - - - - - - - - - - - - - - - - - - - - - - - - - - - - - - - - - - - - -
1 7 7 <-> 47 6 3
6 10 6 <-> 11 17 6
8 4 0 <-> 16 2 7
14 9 2 <-> 23 7 7
15 8 1 <-> 17 6 5
16 17 1 <-> 23 16 5
17 5 3 <-> 26 8 7
27 20 3 <-> 38 20 6
34 15 4 <-> 39 19 7
37 15 4 <-> 40 19 7
38 14 2 <-> 40 14 6
39 12 2 <-> 41 12 5
44 9 0 <-> 45 8 4
