3
3
4 3
19 41
- - - - 0 0 0 0 0 0 0 0 0 0 0 - - - - - - - - - - - 0 0 0 0 0 0 0 0 0 0 0 - - - - 
- - 0 b 0 0 0 0 0 0 0 0 0 c 0 0 0 - - - - - - - 0 0 0 0 0 0 0 0 0 0 0 0 0 0 0 - - 
- 0 0 0 0 0 0 0 0 0 0 0 0 0 0 0 0 0 0 - - - 0 0 0 0 0 0 0 0 0 0 0 0 b 0 0 0 0 0 - 
0 0 0 0 0 0 0 0 0 0 0 0 0 0 0 0 0 0 0 0 - 0 0 0 0 0 0 0 0 0 0 0 0 0 0 0 x 0 0 0 0 
0 0 0 0 0 0 0 0 0 0 - - - - 0 0 0 0 0 0 0 0 0 0 0 0 0 - - - - 0 0 0 0 0 0 0 0 0 0 
0 0 0 x 0 0 0 0 x 0 - - - - - - 0 0 0 0 0 0 0 0 0 - - - - - - 0 0 0 0 0 x 0 0 0 0 
0 0 0 0 0 0 0 0 0 0 - - - - - - - - - 0 0 0 - - - - - - - - - 0 0 0 0 x x x 0 0 0 
0 0 0 0 0 x 0 0 0 0 - - - 0 0 - - - - - - - - - - - 0 0 - - - 0 0 0 0 0 x 0 0 0 0 
- 0 0 0 0 0 0 0 0 0 - - - 0 0 0 0 0 - - - - - 0 0 0 0 0 - - - 0 0 0 0 0 0 0 0 0 - 
- - 0 0 0 0 0 x 0 0 - - - 0 0 0 0 0 0 - - - 0 0 0 0 0 0 - - - 0 0 0 0 0 0 0 0 - - 
- - - 0 0 i 0 0 0 0 - - - 0 0 0 0 0 0 - - - 0 0 0 0 0 0 - - - 0 0 0 0 0 0 0 - - - 
- - - - 0 0 0 0 0 0 - - - 0 0 0 0 0 0 - - - 0 0 0 0 0 0 - - - 0 0 0 0 0 0 - - - - 
- - - - - 0 0 0 0 0 - - - 0 0 0 0 0 0 1 2 3 0 0 0 0 0 0 - - - 0 0 0 0 0 - - - - - 
- - - - - - - 0 0 0 0 - - 0 0 0 0 0 0 3 1 2 0 0 0 0 0 0 - 0 0 0 0 0 - - - - - - - 
- - - - - - - - - 0 0 0 0 0 0 0 0 0 0 2 3 1 0 0 0 0 0 0 0 0 0 0 - - - - - - - - - 
- - - - - - - - - - - 0 0 0 0 0 0 0 0 0 0 0 0 0 0 0 0 0 0 0 - - - - - - - - - - - 
- - - - - - - - - - - - - 0 0 0 0 0 0 0 0 0 0 0 0 0 0 0 - - - - - - - - - - - - - 
- - - - - - - - - - - - - - - 0 0 0 0 0 b 0 0 0 0 0 - - - - - - - - - - - - - - - 
- - - - - - - - - - - - - - - - - - 0 0 0 0 0 - - - - - - - - - - - - - - - - - - 
13 3 4 <-> 13 7 0
14 4 4 <-> 14 7 0
15 4 4 <-> 18 9 0
27 3 4 <-> 27 7 0
26 4 4 <-> 26 7 0
25 4 4 <-> 22 9 0
27 12 2 <-> 31 12 6
9 12 2 <-> 13 12 6
