3
0
0 0
19 19
c c c c c c c c c c c c c c c c c c c 
c 0 0 0 0 0 0 0 0 0 0 0 0 0 0 0 0 0 c 
c 0 c c c c c c c c c c c c c c c 0 c 
c 0 c 0 0 0 0 0 0 0 0 0 0 0 0 0 c 0 c 
c 0 c 0 c c c c c c c c c c c 0 c 0 c 
c 0 c 0 c 0 0 0 0 0 0 0 0 0 c 0 c 0 c 
c 0 c 0 c 0 c c c c c c c 0 c 0 c 0 c 
c 0 c 0 c 0 c 0 0 0 0 0 c 0 c 0 c 0 c 
c 0 c 0 c 0 c 0 1 2 3 0 c 0 c 0 c 0 c 
c 0 c 0 c 0 c 0 3 1 2 0 c 0 c 0 c 0 c 
c 0 c 0 c 0 c 0 1 2 3 0 c 0 c 0 c 0 c 
c 0 c 0 c 0 c 0 0 0 0 0 c 0 c 0 c 0 c 
c 0 c 0 c 0 c c c c c c c 0 c 0 c 0 c 
c 0 c 0 c 0 0 0 0 0 0 0 0 0 c 0 c 0 c 
c 0 c 0 c c c c c c c c c c c 0 c 0 c 
c 0 c 0 0 0 0 0 0 0 0 0 0 0 0 0 c 0 c 
c 0 c c c c c c c c c c c c c c c 0 c 
c 0 0 0 0 0 0 0 0 0 0 0 0 0 0 0 0 0 c 
c c c c c c c c c c c c c c c c c c c 
