3
4
0 1
29 33
- - - - - - - - - - - - 0 0 0 0 0 0 0 0 0 0 - - - - - - - - - - - 
- - - - - - - - - 0 0 0 0 0 0 0 0 0 0 0 0 0 0 - - - - - - - - - - 
- - - - - - - 0 0 0 0 0 0 0 0 0 0 0 0 0 0 0 0 0 0 - - - - - - - - 
- - - - - 0 0 0 0 0 0 0 0 0 0 0 0 0 0 0 0 0 0 0 0 0 0 - - - - - - 
- - - - 0 0 0 0 0 0 0 0 0 0 0 0 0 0 0 0 0 0 0 0 0 0 0 0 - - - - - 
- - - 0 0 0 0 0 0 0 0 0 - - - - - - - - - 0 0 0 0 0 0 0 0 - - - - 
- - - 0 0 0 0 0 0 0 0 - - 0 0 0 0 0 0 0 - - - 0 0 0 0 0 0 0 - - - 
- - 0 0 0 0 0 0 0 - - - 0 0 0 0 0 0 0 0 0 0 - - - 0 0 0 0 0 0 - - 
- - 0 0 0 0 0 0 - - 0 0 0 0 0 0 0 0 0 0 0 0 0 0 - 0 0 0 0 0 0 - - 
- 0 0 0 0 0 0 0 - 0 0 0 0 0 0 0 0 0 0 0 0 0 0 0 - - 0 0 0 0 0 0 - 
- 0 0 0 0 0 0 - - 0 0 0 0 0 0 0 0 0 0 0 0 0 0 0 0 - 0 0 0 0 0 0 - 
- 0 0 0 0 0 0 - 0 0 0 0 0 0 - - - - - - - 0 0 0 0 - - 0 0 0 0 0 0 
- 0 0 0 0 0 - - 0 0 0 0 0 - - c c c c c - 0 0 0 0 0 - 0 0 0 0 0 0 
- 0 0 0 0 0 - 0 0 0 0 0 - - c b b b b c - - 0 0 0 0 - - 0 0 0 0 0 
- 0 0 0 0 0 - 0 0 0 0 0 - c b b b b b b c - 0 0 0 0 0 - 0 0 0 0 0 
- 0 0 0 0 0 - 0 0 0 0 0 - c b b b b b c c - 0 0 0 0 0 - 0 0 0 0 0 
- 0 0 0 0 0 - 0 0 0 0 0 - c c c c c c - - - 0 0 0 0 - - 0 0 0 0 0 
- 0 0 0 0 0 - 0 0 0 0 0 - - 0 0 0 0 0 - 0 0 0 0 0 0 - 0 0 0 0 0 0 
- 0 1 2 3 0 - 0 0 0 0 0 0 - 0 0 0 0 0 0 0 0 0 0 0 0 - 0 0 0 0 0 0 
- 0 3 1 2 0 - 0 0 0 0 0 0 - - 0 0 0 0 0 0 0 0 0 0 - - 0 0 0 0 0 0 
- 0 2 3 1 0 - 0 0 0 0 0 0 0 - - 0 0 0 0 0 0 0 0 0 - 0 0 0 0 0 0 - 
- 0 0 0 0 0 - 0 0 0 0 0 0 0 0 - - 0 0 0 0 0 0 - - - 0 0 0 0 0 0 - 
- - 0 0 0 - - 0 0 0 0 0 0 0 0 0 - - - - - - - - 0 0 0 0 0 0 0 - - 
- - - - - - - 0 0 0 0 0 0 0 0 0 0 0 0 0 0 0 0 0 0 0 0 0 0 0 - - - 
- - - - - - - - 0 0 0 0 0 0 0 0 0 0 0 0 0 0 0 0 0 0 0 0 0 - - - - 
- - - - - - - - 0 0 0 0 0 0 0 0 0 0 0 0 0 0 0 0 0 0 0 0 - - - - - 
- - - - - - - - - 0 0 0 0 0 0 0 0 0 0 0 0 0 0 0 0 0 - - - - - - - 
- - - - - - - - - - - 0 0 0 0 0 0 0 0 0 0 0 0 0 - - - - - - - - - 
- - - - - - - - - - - - - - 0 0 0 0 0 0 0 - - - - - - - - - - - - 
