6
2
0 3
23 23
0 0 0 0 0 0 0 0 0 - - - - - 0 0 0 0 0 0 0 0 0 
0 0 0 0 0 0 0 0 0 - - - - - 0 0 0 0 0 0 0 0 0 
0 0 0 0 0 0 0 0 0 - - - - - 0 0 0 0 0 0 0 0 0 
0 0 0 1 2 3 0 0 0 0 x 0 x 0 0 0 0 0 0 0 0 0 0 
0 0 0 2 3 1 0 0 0 0 x 0 x 0 0 0 0 0 c 0 0 0 0 
0 0 0 3 1 2 0 0 0 0 x 0 x 0 0 0 0 0 0 0 0 0 0 
0 0 0 0 0 0 0 0 0 - - - - - 0 0 0 0 0 0 0 0 0 
0 0 0 0 0 0 0 0 0 - - - - - 0 0 0 0 0 0 0 0 0 
0 0 0 0 0 0 0 0 0 - - - - - 0 0 0 0 0 0 0 0 0 
- - - 0 0 0 - - - - - - - - - - - 0 0 0 - - - 
- - - x x x - - - - - - - - - - - x x x - - - 
- - - 0 0 0 - - - - - b - - - - - 0 0 0 - - - 
- - - x x x - - - - - - - - - - - x x x - - - 
- - - 0 0 0 - - - - - - - - - - - 0 0 0 - - - 
0 0 0 0 0 0 0 0 0 - - - - - 0 0 0 0 0 0 0 0 0 
0 0 0 0 0 0 0 0 0 - - - - - 0 0 0 0 0 0 0 0 0 
0 0 0 0 0 0 0 0 0 - - - - - 0 0 0 0 0 0 0 0 0 
0 0 0 0 0 0 0 0 0 0 x 0 x 0 0 0 0 4 5 6 0 0 0 
0 0 0 0 i 0 0 0 0 0 x 0 x 0 0 0 0 5 6 4 0 0 0 
0 0 0 0 0 0 0 0 0 0 x 0 x 0 0 0 0 6 4 5 0 0 0 
0 0 0 0 0 0 0 0 0 - - - - - 0 0 0 0 0 0 0 0 0 
0 0 0 0 0 0 0 0 0 - - - - - 0 0 0 0 0 0 0 0 0 
0 0 0 0 0 0 0 0 0 - - - - - 0 0 0 0 0 0 0 0 0 
5 11 2 <-> 11 11 6
11 11 0 <-> 11 5 4
17 11 6 <-> 11 11 2
11 11 4 <-> 11 17 0
