6
1
0 8
35 35
- - - - - - - - - 0 - 0 - 0 - 0 - 0 - 0 - 0 - 0 - 0 - - - - - - - - - 
- - - - - - - - - - 0 0 0 0 0 0 0 0 0 0 0 0 0 0 0 - - - - - - - - - - 
- - - - - - - - - 0 0 0 0 0 0 0 x x x 0 0 0 0 0 0 0 - - - - - - - - - 
- - - - - - - - - - 0 0 0 0 0 0 x x x 0 0 0 0 0 0 - - - - - - - - - - 
- - - - - - - - - 0 0 0 0 0 0 0 x x x 0 0 0 0 0 0 0 - - - - - - - - - 
- - - - - - - - - - 0 0 0 0 0 0 0 0 0 0 0 0 0 0 0 - - - - - - - - - - 
- - - - - - - - - 0 - 0 - 0 - 0 0 0 0 0 - 0 - 0 - 0 - - - - - - - - - 
- - - - - - - - - - - - - - - - 0 0 0 - - - - - - - - - - - - - - - - 
- - - - - - - - - - - - - - - - 0 0 0 - - - - - - - - - - - - - - - - 
0 - 0 - 0 - 0 - - - - - - - - - 0 0 0 - - - - - - - - - 0 - 0 - 0 - 0 
- 0 0 0 0 0 - - - - - - - - - - 0 0 0 - - - - - - - - - - 0 0 0 0 0 - 
0 0 0 0 0 0 0 - - - - - - - - - 0 0 0 - - - - - - - - - 0 0 0 0 0 0 0 
- 0 0 0 0 0 - - - - - - - - - - 0 0 0 - - - - - - - - - - 0 0 0 0 0 - 
0 0 0 0 0 0 0 - - - - - - - - - 0 0 0 - - - - - - - - - 0 0 0 0 0 0 0 
- 0 0 0 0 0 - - - - - - - - - - 0 0 0 - - - - - - - - - - 0 0 0 0 0 - 
0 0 0 0 0 0 0 - - - - - - - - 0 0 0 0 0 - - - - - - - - 0 0 0 0 0 0 0 
- 0 1 2 3 0 0 0 0 0 0 0 0 0 0 0 0 0 0 0 0 0 0 0 0 0 0 0 0 0 4 5 6 0 - 
0 0 3 1 2 0 0 0 0 0 0 0 0 0 0 0 0 b 0 0 0 0 0 0 0 0 0 0 0 0 6 4 5 0 0 
- 0 2 3 1 0 0 0 0 0 0 0 0 0 0 0 0 0 0 0 0 0 0 0 0 0 0 0 0 0 5 6 4 0 - 
0 0 0 0 0 0 0 - - - - - - - - 0 0 0 0 0 - - - - - - - - 0 0 0 0 0 0 0 
- 0 0 0 0 0 - - - - - - - - - - 0 0 0 - - - - - - - - - - 0 0 0 0 0 - 
0 0 0 0 0 0 0 - - - - - - - - - 0 0 0 - - - - - - - - - 0 0 0 0 0 0 0 
- 0 0 0 0 0 - - - - - - - - - - 0 0 0 - - - - - - - - - - 0 0 0 0 0 - 
0 0 0 0 0 0 0 - - - - - - - - - 0 0 0 - - - - - - - - - 0 0 0 0 0 0 0 
- 0 0 0 0 0 - - - - - - - - - - 0 0 0 - - - - - - - - - - 0 0 0 0 0 - 
0 - 0 - 0 - 0 - - - - - - - - - 0 0 0 - - - - - - - - - 0 - 0 - 0 - 0 
- - - - - - - - - - - - - - - - 0 0 0 - - - - - - - - - - - - - - - - 
- - - - - - - - - - - - - - - - 0 0 0 - - - - - - - - - - - - - - - - 
- - - - - - - - - 0 - 0 - 0 - 0 0 0 0 0 - 0 - 0 - 0 - - - - - - - - - 
- - - - - - - - - - 0 0 0 0 0 0 0 0 0 0 0 0 0 0 0 - - - - - - - - - - 
- - - - - - - - - 0 0 0 0 0 0 0 x x x 0 0 0 0 0 0 0 - - - - - - - - - 
- - - - - - - - - - 0 0 0 0 0 0 x x x 0 0 0 0 0 0 - - - - - - - - - - 
- - - - - - - - - 0 0 0 0 0 0 0 x x x 0 0 0 0 0 0 0 - - - - - - - - - 
- - - - - - - - - - 0 0 0 0 0 0 0 0 0 0 0 0 0 0 0 - - - - - - - - - - 
- - - - - - - - - 0 - 0 - 0 - 0 - 0 - 0 - 0 - 0 - 0 - - - - - - - - - 
