6
3
1 1
19 37
- - - - - - - - - - - - - - - - - - b - - - - - - - - - - - - - - - - - -
- - - - - - - - - - - - - - - - - 0 0 0 - - - - - - - - - - - - - - - - -
- - - - - - - - - - - - - - - - 0 0 0 0 0 - - - - - - - - - - - - - - - -
- - - - - - - - - - - - - - - 0 0 0 0 0 0 0 - - - - - - - - - - - - - - -
- - - - - - - - - - - - - - 0 0 0 5 6 5 0 0 0 - - - - - - - - - - - - - -
- - - - - - - - - - - - - 0 0 0 0 6 5 6 0 0 0 0 - - - - - - - - - - - - -
- - - - - - - - - - - - 0 0 0 0 0 0 0 0 0 0 0 0 0 - - - - - - - - - - - -
- - - - - - - - - - - 0 0 0 0 0 0 0 0 0 0 0 0 0 0 0 - - - - - - - - - - -
- - - - - - - - - - i 0 0 0 0 0 0 0 0 0 0 0 0 0 0 0 0 - - - - - - - - - -
- - - - - - - - - 0 - - - - - - - - - - - - - - - - - i - - - - - - - - -
- - - - - - - - 0 0 0 - - - - - - - - - - - - - - - 0 0 0 - - - - - - - -
- - - - - - - 0 0 0 0 0 - - - - - - - - - - - - - 0 0 0 0 0 - - - - - - -
- - - - - - 0 0 0 0 0 0 0 - - - - - - - - - - - 0 0 0 0 0 0 0 - - - - - -
- - - - - 0 0 0 0 0 0 0 0 0 - - - - - - - - - 0 0 0 0 0 0 0 0 0 - - - - -
- - - - 0 0 0 0 0 0 0 0 0 0 0 - - - - - - - 0 0 0 0 0 0 0 0 0 0 0 - - - -
- - - 0 0 0 0 0 0 0 0 0 0 0 0 0 - - - - - 0 0 0 0 0 0 0 0 0 0 0 0 0 - - -
- - 0 0 0 0 0 0 2 1 2 0 0 0 0 0 0 - - - 0 0 0 0 0 0 3 4 3 0 0 0 0 0 0 - -
- 0 0 0 0 0 0 0 1 2 1 0 0 0 0 0 0 0 - 0 0 0 0 0 0 0 4 3 4 0 0 0 0 0 0 0 -
c 0 0 0 0 0 0 0 0 0 0 0 0 0 0 0 0 0 b 0 0 0 0 0 0 0 0 0 0 0 0 0 0 0 0 0 c
0 18 5 <-> 18 0 1
36 18 3 <-> 18 0 7
10 8 4 <-> 10 10 0
11 8 4 <-> 11 11 0
12 8 4 <-> 12 12 0
13 8 4 <-> 13 13 0
14 8 4 <-> 14 14 0
15 8 4 <-> 15 15 0
16 8 4 <-> 16 16 0
17 8 4 <-> 17 17 0
18 8 4 <-> 18 18 0 
19 8 4 <-> 19 17 0
20 8 4 <-> 20 16 0
21 8 4 <-> 21 15 0
22 8 4 <-> 22 14 0
23 8 4 <-> 23 13 0
24 8 4 <-> 24 12 0
25 8 4 <-> 25 11 0
26 8 4 <-> 26 10 0