6
5
2 2
38 45
- - - - - - - - - - - - - - - - - - - - - - - - - - - - - - - - - - - - - - - - - - - - - 
- - - - - - - - - - - - - - - - - - - - - - - - - - - - - - - - - - - - - - - - - - - - - 
- - - - - - - - - - - - - - - - - - - - - - - - - - - - - - - - - - - - - - - - - - - - - 
- - - - - - - - - - - - - - - 0 0 0 0 0 0 0 0 0 0 0 0 0 0 0 0 0 0 0 0 0 0 0 - - - - - - - 
- - - - - - - - - - - - - - - 0 0 0 0 0 0 0 0 0 0 0 0 0 0 0 0 0 0 0 0 0 0 0 - - - - - - - 
- - - - - - - - - - - - - - - 0 0 0 0 0 0 0 0 0 0 0 0 0 0 0 0 0 0 0 0 0 0 0 - - - - - - - 
- - - - - - - - - - - x 0 0 0 0 0 0 0 0 0 0 0 0 0 1 2 3 0 0 0 0 0 0 0 0 0 0 0 0 0 x - - - 
- - - - - - - - - - - 0 x 0 0 0 0 0 0 0 0 0 0 0 0 3 1 2 0 0 0 0 0 0 0 0 0 0 0 0 x 0 - - - 
- - - - - - - - - - - 0 0 x 0 0 0 0 0 0 0 0 0 0 0 2 3 1 0 0 0 0 0 0 0 0 0 0 0 x 0 0 - - - 
- - - - - - - - - - - 0 0 0 x 0 0 0 0 0 0 0 0 0 0 0 0 0 0 0 0 0 0 0 0 0 0 0 x 0 0 0 - - - 
- - - - - - - - 0 0 0 0 0 0 0 x 0 0 0 0 0 0 0 0 0 0 0 0 0 0 0 0 0 0 0 0 0 x 0 0 0 0 0 0 0 
- - - - - - - - 0 0 0 0 0 0 0 0 x 0 0 0 0 0 0 0 0 0 0 0 0 0 0 0 0 0 0 0 x 0 0 0 0 0 0 0 0 
- - - - - - - - 0 0 0 0 0 0 0 0 0 x 0 0 0 0 0 0 0 0 0 0 0 0 0 0 0 0 0 x 0 0 0 0 0 0 0 0 0 
- - - - - - - - 0 0 0 0 0 0 0 0 0 0 x 0 0 0 0 0 0 0 0 0 0 0 0 0 0 0 x 0 0 0 0 0 0 0 0 0 0 
- - - - - - - - 0 0 0 0 0 0 0 0 0 0 0 x 0 0 0 0 0 0 0 0 0 0 0 0 0 x 0 0 0 0 0 0 0 0 0 0 0 
- - - - - - - - 0 0 0 0 0 0 0 0 0 0 0 0 x 0 0 0 0 0 0 0 0 0 0 0 x 0 0 0 0 0 0 0 0 0 0 0 0 
- - - - - - - - 0 0 0 0 0 0 0 0 0 0 0 0 0 x 0 0 0 0 0 0 0 0 0 x 0 0 0 0 0 0 0 0 0 0 0 0 0 
- - - - - - - - 0 0 0 0 0 0 0 - - - - - - - - - - - - - - - - - - - - - - - 0 0 0 0 0 0 0 
- - - - - - - - 0 0 0 0 0 0 0 - - - - - - - - - - - - - - - - - - - - - - - 0 0 0 0 0 0 0 
- - - - - - - - 0 0 1 2 3 0 0 - - 0 0 0 0 0 0 0 0 b 0 b 0 0 0 0 0 0 0 0 - - 0 0 4 5 6 0 0 
- - - - - - - - 0 0 3 1 2 0 0 - - 0 0 0 0 0 0 0 0 i c i 0 0 0 0 0 0 0 0 - - 0 0 6 4 5 0 0 
- - - - - - - - 0 0 2 3 1 0 0 - - 0 0 0 0 0 0 0 0 b 0 b 0 0 0 0 0 0 0 0 - - 0 0 5 6 4 0 0 
- - - - - - - - 0 0 0 0 0 0 0 - - - - - - - - - - - - - - - - - - - - - - - 0 0 0 0 0 0 0 
- - - - - - - - 0 0 0 0 0 0 0 - - - - - - - - - - - - - - - - - - - - - - - 0 0 0 0 0 0 0 
- - - - - - - - 0 0 0 0 0 0 0 0 0 0 0 0 0 x 0 0 0 0 0 0 0 0 0 x 0 0 0 0 0 0 0 0 0 0 0 0 0 
- - - - - - - - 0 0 0 0 0 0 0 0 0 0 0 0 x 0 0 0 0 0 0 0 0 0 0 0 x 0 0 0 0 0 0 0 0 0 0 0 0 
- - - - - - - - 0 0 0 0 0 0 0 0 0 0 0 x 0 0 0 0 0 0 0 0 0 0 0 0 0 x 0 0 0 0 0 0 0 0 0 0 0 
- - - - - - - - 0 0 0 0 0 0 0 0 0 0 x 0 0 0 0 0 0 0 0 0 0 0 0 0 0 0 x 0 0 0 0 0 0 0 0 0 0 
- - - - - - - - 0 0 0 0 0 0 0 0 0 x 0 0 0 0 0 0 0 0 0 0 0 0 0 0 0 0 0 x 0 0 0 0 0 0 0 0 0 
- - - - - - - - 0 0 0 0 0 0 0 0 x 0 0 0 0 0 0 0 0 0 0 0 0 0 0 0 0 0 0 0 x 0 0 0 0 0 0 0 0 
- - - - - - - - 0 0 0 0 0 0 0 x 0 0 0 0 0 0 0 0 0 0 0 0 0 0 0 0 0 0 0 0 0 x 0 0 0 0 0 0 0 
- - - - - - - - - - - 0 0 0 x 0 0 0 0 0 0 0 0 0 0 0 0 0 0 0 0 0 0 0 0 0 0 0 x 0 0 0 - - - 
- - - - - - - - - - - 0 0 x 0 0 0 0 0 0 0 0 0 0 0 4 5 6 0 0 0 0 0 0 0 0 0 0 0 x 0 0 - - - 
- - - - - - - - - - - 0 x 0 0 0 0 0 0 0 0 0 0 0 0 6 4 5 0 0 0 0 0 0 0 0 0 0 0 0 x 0 - - - 
- - - - - - - - - - - x 0 0 0 0 0 0 0 0 0 0 0 0 0 5 6 4 0 0 0 0 0 0 0 0 0 0 0 0 0 x - - - 
- - - - - - - - - - - - - - - 0 0 0 0 0 0 0 0 0 0 0 0 0 0 0 0 0 0 0 0 0 0 0 - - - - - - - 
- - - - - - - - - - - - - - - 0 0 0 0 0 0 0 0 0 0 0 0 0 0 0 0 0 0 0 0 0 0 0 - - - - - - - 
- - - - - - - - - - - - - - - 0 0 0 0 0 0 0 0 0 0 0 0 0 0 0 0 0 0 0 0 0 0 0 - - - - - - - 
35 19 2 <-> 38 19 6
35 20 2 <-> 38 20 6
35 21 2 <-> 38 21 6
14 19 2 <-> 17 19 6
17 20 6 <-> 14 20 2
17 21 6 <-> 14 21 2
25 19 0 <-> 25 16 4
26 16 4 <-> 26 19 0
27 16 4 <-> 27 19 0
27 21 4 <-> 27 24 0
26 21 4 <-> 26 24 0
25 21 4 <-> 25 24 0
