6
3
1 1
20 20
0 0 0 0 0 0 0 0 0 0 0 0 0 0 0 0 0 0 0 0
0 c 0 0 0 6 0 5 0 4 0 3 0 2 0 1 0 0 i 0
0 0 0 0 0 0 0 0 0 0 0 0 0 0 0 0 0 0 0 0
0 0 0 0 0 0 0 0 0 - - 0 0 0 0 0 0 0 0 0
0 0 b b 0 0 0 0 0 - - 0 0 0 0 0 b b 0 0
0 0 0 0 0 0 0 0 0 0 0 0 0 0 0 0 0 0 0 0
0 0 0 0 - - 0 1 6 2 3 5 4 0 - - 0 0 0 0
0 0 0 0 - - 0 2 4 1 5 6 3 0 - - 0 0 0 0
0 c 0 0 - - 0 5 1 2 3 4 6 0 - - 0 0 0 0
0 0 0 0 - - 0 3 4 6 2 5 1 0 - - 0 0 0 0
0 0 0 0 - - 0 6 2 3 1 4 5 0 - - 0 0 0 0
0 0 0 0 - - 0 4 5 6 2 1 3 0 - - 0 0 0 0
0 0 0 0 0 0 0 0 0 0 0 0 0 0 0 0 0 0 0 0
0 0 b b 0 0 0 0 0 0 0 0 0 0 0 0 b b 0 0
0 0 0 0 0 0 0 0 0 0 0 0 0 0 0 0 0 0 0 0
0 0 0 0 1 0 2 0 3 0 4 0 5 0 6 0 0 0 0 0
0 0 0 0 0 0 0 0 0 0 0 0 0 0 0 0 0 0 0 0
0 0 0 0 0 0 0 0 - - - - 0 0 0 0 0 0 0 0
0 i 0 0 0 0 0 b 0 0 0 0 b 0 0 0 0 0 c 0
0 0 0 0 0 0 0 0 0 0 0 0 0 0 0 0 0 0 0 0
3 6 2 <-> 16 6 6
3 7 2 <-> 16 7 6
3 8 2 <-> 16 8 6
3 9 2 <-> 16 9 6
3 10 2 <-> 16 10 6
3 11 2 <-> 16 11 6
0 0 7 <-> 19 19 3
19 0 1 <-> 0 19 5
