6
3
0 2
30 40
- - - - - - - - - - - - 0 0 0 0 0 0 2 0 0 0 0 0 0 0 0 0 0 0 0 - - - - - - - - -
- - - - 0 0 0 0 0 0 0 0 0 0 0 0 0 0 0 0 0 0 0 b 0 0 0 0 0 0 0 0 - - - - - - - -
0 0 0 0 0 0 0 0 0 0 0 0 0 0 0 0 0 0 0 0 0 0 0 0 0 0 0 0 0 0 0 0 1 - - - - - - -
0 0 0 0 0 0 0 0 0 0 0 0 0 0 0 0 0 0 0 - - - - - - - 0 0 0 0 0 0 0 2 - - - - - -
c 0 0 0 0 5 2 3 0 0 - - - - - 0 0 0 0 - 0 0 0 0 0 - 0 0 0 b 0 0 0 0 3 - - - - -
0 0 0 0 0 4 6 1 0 0 0 - - - 0 0 0 0 0 - 0 0 i 0 0 - 0 0 0 0 0 0 0 0 0 4 - - - -
0 0 0 0 0 3 5 4 0 0 0 0 - 0 0 0 0 0 0 0 0 0 - 0 0 0 0 0 0 0 0 0 0 0 0 0 5 - - -
0 0 0 0 0 2 1 6 0 0 0 - - - 0 0 0 0 0 - 0 0 i 0 0 - 0 0 0 0 0 0 0 0 0 0 0 6 - -
0 0 0 0 0 0 0 0 0 0 - - - - - 0 0 0 0 - 0 0 0 0 0 - 0 0 0 0 0 0 0 0 0 0 0 0 0 -
0 0 0 0 0 0 0 0 0 0 0 0 0 0 0 0 0 0 0 - - - - - - - 0 0 0 0 0 0 0 0 0 0 0 0 0 0
0 0 0 0 0 0 0 0 0 0 - - - - - 0 0 0 0 0 0 0 0 0 0 0 0 1 2 3 4 5 6 0 0 0 0 b 0 0
0 0 0 0 0 0 0 0 0 0 0 - - - 0 0 0 0 0 0 0 0 0 0 0 0 0 3 4 5 6 1 2 0 0 0 0 0 0 0
0 6 0 0 0 0 0 0 0 0 0 0 - 0 0 0 0 3 0 0 0 0 0 0 0 0 0 5 6 1 2 3 4 0 0 0 0 0 0 0
0 0 0 0 b 0 0 0 0 0 0 - - - 0 0 0 0 0 0 b 0 0 0 0 0 0 2 3 4 5 6 1 0 0 0 0 0 0 0
0 0 0 0 0 0 0 0 0 0 - - - - - 0 0 0 0 0 0 0 0 0 0 0 0 4 5 6 1 2 3 0 0 0 0 0 0 0
0 0 0 0 0 0 0 0 0 0 0 0 0 0 0 0 0 0 0 0 0 0 0 0 0 0 0 6 1 2 3 4 5 0 0 0 0 0 0 0
b 0 0 0 0 0 0 0 0 0 0 0 0 0 0 0 0 0 0 0 0 0 0 0 0 0 0 0 0 0 0 0 0 0 0 0 0 0 0 0
0 0 0 0 0 0 0 0 0 0 0 0 0 0 0 4 0 0 0 0 0 0 0 0 0 0 0 0 0 0 0 0 0 0 0 0 0 0 c 0
0 0 0 0 1 2 3 4 5 6 0 0 0 0 0 0 0 0 0 0 0 0 0 0 0 0 0 0 0 0 0 0 0 0 0 0 0 0 0 0
0 0 0 0 3 4 5 6 1 2 0 0 0 0 0 0 0 0 - - - - - - - - - - - - - - - - - - - - - -
0 0 0 0 5 6 1 2 3 4 0 0 0 0 b 0 0 0 - - - - - - - - - - - - - - - - - - - - - -
0 0 0 0 2 3 4 5 6 1 0 0 0 0 0 0 0 0 - - - - - - - - - - - - - - - - - - - - - -
0 0 0 0 4 5 6 1 2 3 0 0 0 0 0 0 0 0 - - - - - - - - - - - - - - - - - - - - - -
0 0 0 0 6 1 2 3 4 5 0 0 0 0 0 0 0 0 - - - - - - - - - - - - - - - - - - - - - -
0 0 0 0 0 0 0 0 0 0 0 0 0 0 0 0 0 0 - - - - - - - - - 0 0 0 0 - - - - - - - - -
0 0 0 0 - - - - - - 0 0 0 0 0 0 0 0 - - - - - - - - - 0 0 0 0 - - - - - - - - -
0 0 0 0 0 0 0 0 0 0 0 0 0 0 0 0 0 0 0 0 0 c 0 0 0 0 0 0 0 0 0 0 0 0 0 0 0 0 0 0
0 0 0 0 0 0 b 0 0 0 0 0 0 0 b 0 0 0 0 0 0 0 0 0 0 0 0 0 0 0 0 0 0 0 0 0 0 0 0 0
0 0 0 0 0 0 0 0 0 0 0 0 0 0 0 0 0 0 0 0 0 0 0 0 0 0 0 0 0 0 0 0 0 0 0 0 0 0 0 0
0 0 0 0 0 0 0 0 0 0 0 0 0 0 0 0 0 0 0 0 0 0 0 0 0 5 0 0 0 0 0 0 0 0 0 0 0 0 0 0
30 18 4 <-> 30 24 0
27 18 4 <-> 27 24 0
10 3 4 <-> 14 15 0
14 3 4 <-> 10 15 0
24 4 1 <-> 20 18 5
24 8 3 <-> 6 26 7
20 4 7 <-> 17 22 3
20 8 5 <-> 36 26 1
