6
0
0 5
15 25
- - - - - 0 0 0 0 0 - - - - - 0 0 0 0 0 - - - - -
- - - - - 0 0 0 0 0 - - - - - 0 0 0 0 0 - - - - -
- - - - - 0 0 c 0 0 - - - - - 0 0 b 0 0 - - - - -
- - - - - 0 0 0 0 0 - - - - - 0 0 0 0 0 - - - - -
- - - - - 0 0 0 0 0 - - - - - 0 0 0 0 0 - - - - -
0 0 0 0 0 - - - - - 0 0 0 0 0 - - - - - 0 0 0 0 0
0 0 0 0 0 - - - - - 0 1 2 0 0 - - - - - 0 0 5 6 0
0 3 4 0 0 - - - - - 0 2 1 0 0 - - - - - 0 0 6 5 0
0 4 3 0 0 - - - - - 0 0 0 0 0 - - - - - 0 0 0 0 0
0 0 0 0 0 - - - - - 0 0 0 0 0 - - - - - 0 0 0 0 0
- - - - - 0 0 0 0 0 - - - - - 0 0 0 0 0 - - - - -
- - - - - 0 0 0 0 0 - - - - - 0 0 0 0 0 - - - - -
- - - - - 0 0 b 0 0 - - - - - 0 0 c 0 0 - - - - -
- - - - - 0 0 0 0 0 - - - - - 0 0 0 0 0 - - - - -
- - - - - 0 0 0 0 0 - - - - - 0 0 0 0 0 - - - - -
5 0 7 <-> 19 14 3
19 0 1 <-> 5 14 5