4
0
0 3
24 24
- - - - - - - - - - - 0 0 - - - - - - - - - - - 
- - - - - - - - - 0 0 0 0 0 0 - - - - - - - - - 
- - - - - - - - - 0 0 0 0 0 0 - - - - - - - - - 
- - - - - - - - - 0 0 0 0 0 0 - - - - - - - - - 
- - - - - - - - - 0 0 0 0 0 0 - - - - - - - - - 
- - - - - 0 0 0 0 0 0 0 0 0 0 0 0 0 0 - - - - - 
- - - - - 0 0 0 0 0 0 b 0 0 0 0 0 0 0 - - - - - 
- - - - - 0 0 0 0 0 0 0 0 0 0 0 0 0 0 - - - - - 
- - - - - 0 0 0 0 0 0 0 0 0 0 0 0 0 0 - - - - - 
- 0 0 0 0 0 0 0 0 0 0 0 0 0 0 0 0 0 0 0 0 0 0 - 
- 0 0 0 0 0 0 0 0 0 3 2 1 4 0 0 0 0 0 0 0 0 0 - 
0 0 0 0 0 0 0 0 0 0 4 1 2 3 0 0 0 b 0 0 0 0 0 0 
0 0 0 0 0 0 b 0 0 0 4 2 1 3 0 0 0 0 0 0 0 0 0 0 
- 0 0 0 0 0 0 0 0 0 3 1 2 4 0 0 0 0 0 0 0 0 0 - 
- 0 0 0 0 0 0 0 0 0 0 0 0 0 0 0 0 0 0 0 0 0 0 - 
- - - - - 0 0 0 0 0 0 0 0 0 0 0 0 0 0 - - - - - 
- - - - - 0 0 0 0 0 0 0 0 0 0 0 0 0 0 - - - - - 
- - - - - 0 0 0 0 0 0 0 b 0 0 0 0 0 0 - - - - - 
- - - - - 0 0 0 0 0 0 0 0 0 0 0 0 0 0 - - - - - 
- - - - - - - - - 0 0 0 0 0 0 - - - - - - - - - 
- - - - - - - - - 0 0 0 0 0 0 - - - - - - - - - 
- - - - - - - - - 0 0 0 0 0 0 - - - - - - - - - 
- - - - - - - - - 0 0 0 0 0 0 - - - - - - - - - 
- - - - - - - - - - - 0 0 - - - - - - - - - - - 
