4
2
0 0
22 40
- - - - - - - 0 0 0 0 0 0 - - - - - - - - - 0 - - - - - - - - - - - - - - - - - 
- - 0 - - 0 0 0 0 - 0 0 0 - - - - - - - - - - - - 0 0 0 0 0 0 0 - - - - - - - - 
- 0 0 0 0 0 - 0 0 - - 0 - - 0 - - - - 0 0 0 - 0 0 0 0 0 0 0 0 0 0 0 0 0 0 - - 0 
- - 0 4 4 0 0 - 0 - - - - - - - 2 - - - 0 0 0 0 0 0 0 0 0 0 0 0 0 0 0 0 0 0 0 - 
- - 0 0 0 0 0 0 0 0 - - - - - - - - 2 - 0 0 0 0 0 0 0 0 0 0 0 0 0 0 0 0 0 - 0 - 
- - 0 0 0 3 4 0 0 - - - - - - - 2 0 0 0 0 0 0 0 0 0 0 0 0 0 0 0 3 3 0 - 0 - - - 
- - 0 0 0 4 3 0 0 - - - - - - 0 0 0 0 0 0 0 0 0 0 0 0 0 0 0 0 0 0 3 3 - - - - - 
- - - 0 0 0 0 0 0 - - - - - - - 0 - 0 - 0 - 0 0 0 0 0 0 0 0 0 0 0 0 0 - 0 - - - 
0 - - - 0 0 - - 0 - - - - - 0 0 0 0 0 0 0 0 0 0 0 0 0 0 0 0 0 0 0 0 0 - 0 - - 0 
- - - - 0 0 - - - - - - - 0 0 0 0 0 0 0 0 - 0 0 0 0 0 0 0 0 0 0 0 0 0 - - - - - 
- - - - 0 - - 0 - - - - - 0 0 1 0 0 0 1 2 0 - 0 0 - 0 0 0 0 0 0 0 - - - - - - - 
- - - - - 0 - - - - - - - - 0 0 0 0 0 2 1 0 0 - 0 - 0 0 0 0 0 - - - 0 - - - - - 
- - - - - - 0 0 0 0 - - - - 0 1 0 0 0 0 0 0 0 - - - - 0 - 0 0 - 0 - - 0 0 - - - 
- - - - - 0 0 0 0 0 0 - - - - 0 0 0 0 0 0 0 - - - - - - - - - - 0 - 0 0 - 0 - - 
- - - - - 0 0 4 4 0 0 0 - - - - - 0 1 0 0 - - - - - - - - - - - - 0 0 0 0 0 0 - 
- 0 - - - 0 0 0 0 0 0 - - - - - - 0 0 0 0 - - - - - - - - - - - - 0 0 0 0 0 0 - 
- - - - - - - 0 0 0 - - - - - - - 0 0 0 - 0 - - - - - - - 0 - - - 0 0 0 0 0 - - 
- - - - - - - 0 0 0 - - - - - - - 0 0 - - - - - - - - - - - - - - - 0 - 0 - - 0 
- - - - - - - - 0 0 - - - - - - - 0 0 - - - - - - - - - - - - - - - - - 0 - 0 - 
- - - - - - - - - 0 - - - - - - - - - - - - - - - - - - - - - - - - - - - - - - 
- - - - - - - - - - - - - - - - - - - - - - - - - - - - - - - - - - - - - - - - 
- - - - - - - - - - 0 0 0 - - - - - - - 0 0 0 0 0 0 0 0 0 - - - - - - - - - - - 
14 2 6 <-> 11 2 2
18 4 7 <-> 12 1 3
19 2 5 <-> 18 4 0
39 8 6 <-> 36 8 2
39 8 2 <-> 0 8 6
2 6 5 <-> 0 8 1
8 6 2 <-> 15 6 6
15 6 5 <-> 9 12 1
7 10 1 <-> 8 8 4
5 15 6 <-> 1 15 2
1 15 6 <-> 39 17 1
38 18 5 <-> 28 21 2
12 21 4 <-> 20 21 4
11 21 4 <-> 24 21 4
10 21 4 <-> 27 21 4
29 16 5 <-> 27 21 0
27 12 3 <-> 29 16 7
36 7 6 <-> 34 7 2
39 2 2 <-> 1 2 6
22 0 3 <-> 25 1 6
14 12 5 <-> 11 14 1
34 11 7 <-> 32 10 3
32 13 7 <-> 30 12 2
32 12 7 <-> 30 11 2
