4
5
10 0
10 10
0 0 0 0 0 0 0 0 0 0
0 0 0 0 0 0 0 0 0 0
0 0 0 0 0 0 0 0 0 0
0 0 0 1 2 3 4 0 0 0
0 0 0 2 3 4 1 0 0 0
0 0 0 3 4 1 2 0 0 0
0 0 0 4 1 2 3 0 0 0
0 0 0 0 0 0 0 0 0 0
0 0 0 0 0 0 0 0 0 0
0 0 0 0 0 0 0 0 0 0
0 0 0 <-> 9 9 2
1 0 0 <-> 9 8 2
2 0 0 <-> 9 7 2
3 0 0 <-> 9 6 2
4 0 0 <-> 9 5 2
5 0 0 <-> 9 4 2
6 0 0 <-> 9 3 2
7 0 0 <-> 9 2 2
8 0 0 <-> 9 1 2
9 0 0 <-> 9 0 2
9 0 1 <-> 9 0 1
0 0 6 <-> 9 9 4
0 1 6 <-> 8 9 4
0 2 6 <-> 7 9 4
0 3 6 <-> 6 9 4
0 4 6 <-> 5 9 4
0 5 6 <-> 4 9 4
0 6 6 <-> 3 9 4
0 7 6 <-> 2 9 4
0 8 6 <-> 1 9 4
0 9 6 <-> 0 9 4
0 9 5 <-> 0 9 5

