4
42
0 0
47 47
b - b - b - b - b - b - b - b - b - b - b - b - b - b - b - b - b - b - b - b - b - b - b - b
1 - 2 - 3 - 4 - 1 - 2 - 3 - 4 - 1 - 2 - 3 - 4 - 1 - 2 - 3 - 4 - 1 - 2 - 3 - 4 - 1 - 2 - 3 - 4
2 - 3 - 4 - 1 - 2 - 3 - 4 - 1 - 2 - 3 - 4 - 1 - 2 - 3 - 4 - 1 - 2 - 3 - 4 - 1 - 2 - 3 - 4 - 1
- - - - - - - - - - - - - - - - - - - - - - - - - - - - - - - - - - - - - - - - - - - - - - -
b - b - b - b - b - b - b - b - b - b - b - b - b - b - b - b - b - b - b - b - b - b - b - b
1 - 2 - 3 - 4 - 1 - 2 - 3 - 4 - 1 - 2 - 3 - 4 - 1 - 2 - 3 - 4 - 1 - 2 - 3 - 4 - 1 - 2 - 3 - 4
2 - 3 - 4 - 1 - 2 - 3 - 4 - 1 - 2 - 3 - 4 - 1 - 2 - 3 - 4 - 1 - 2 - 3 - 4 - 1 - 2 - 3 - 4 - 1
- - - - - - - - - - - - - - - - - - - - - - - - - - - - - - - - - - - - - - - - - - - - - - -
b - b - b - b - b - b - b - b - b - b - b - b - b - b - b - b - b - b - b - b - b - b - b - b
1 - 2 - 3 - 4 - 1 - 2 - 3 - 4 - 1 - 2 - 3 - 4 - 1 - 2 - 3 - 4 - 1 - 2 - 3 - 4 - 1 - 2 - 3 - 4
2 - 3 - 4 - 1 - 2 - 3 - 4 - 1 - 2 - 3 - 4 - 1 - 2 - 3 - 4 - 1 - 2 - 3 - 4 - 1 - 2 - 3 - 4 - 1
- - - - - - - - - - - - - - - - - - - - - - - - - - - - - - - - - - - - - - - - - - - - - - -
b - b - b - b - b - b - b - b - b - b - b - b - b - b - b - b - b - b - b - b - b - b - b - b
1 - 2 - 3 - 4 - 1 - 2 - 3 - 4 - 1 - 2 - 3 - 4 - 1 - 2 - 3 - 4 - 1 - 2 - 3 - 4 - 1 - 2 - 3 - 4
2 - 3 - 4 - 1 - 2 - 3 - 4 - 1 - 2 - 3 - 4 - 1 - 2 - 3 - 4 - 1 - 2 - 3 - 4 - 1 - 2 - 3 - 4 - 1
- - - - - - - - - - - - - - - - - - - - - - - - - - - - - - - - - - - - - - - - - - - - - - -
b - b - b - b - b - b - b - b - b - b - b - b - b - b - b - b - b - b - b - b - b - b - b - b
1 - 2 - 3 - 4 - 1 - 2 - 3 - 4 - 1 - 2 - 3 - 4 - 1 - 2 - 3 - 4 - 1 - 2 - 3 - 4 - 1 - 2 - 3 - 4
2 - 3 - 4 - 1 - 2 - 3 - 4 - 1 - 2 - 3 - 4 - 1 - 2 - 3 - 4 - 1 - 2 - 3 - 4 - 1 - 2 - 3 - 4 - 1
- - - - - - - - - - - - - - - - - - - - - - - - - - - - - - - - - - - - - - - - - - - - - - -
b - b - b - b - b - b - b - b - b - b - b - b - b - b - b - b - b - b - b - b - b - b - b - b
1 - 2 - 3 - 4 - 1 - 2 - 3 - 4 - 1 - 2 - 3 - 4 - 1 - 2 - 3 - 4 - 1 - 2 - 3 - 4 - 1 - 2 - 3 - 4
2 - 3 - 4 - 1 - 2 - 3 - 4 - 1 - 2 - 3 - 4 - 1 - 2 - 3 - 4 - 1 - 2 - 3 - 4 - 1 - 2 - 3 - 4 - 1
- - - - - - - - - - - - - - - - - - - - - - - - - - - - - - - - - - - - - - - - - - - - - - -
b - b - b - b - b - b - b - b - b - b - b - b - b - b - b - b - b - b - b - b - b - b - b - b
1 - 2 - 3 - 4 - 1 - 2 - 3 - 4 - 1 - 2 - 3 - 4 - 1 - 2 - 3 - 4 - 1 - 2 - 3 - 4 - 1 - 2 - 3 - 4
2 - 3 - 4 - 1 - 2 - 3 - 4 - 1 - 2 - 3 - 4 - 1 - 2 - 3 - 4 - 1 - 2 - 3 - 4 - 1 - 2 - 3 - 4 - 1
- - - - - - - - - - - - - - - - - - - - - - - - - - - - - - - - - - - - - - - - - - - - - - -
b - b - b - b - b - b - b - b - b - b - b - b - b - b - b - b - b - b - b - b - b - b - b - b
1 - 2 - 3 - 4 - 1 - 2 - 3 - 4 - 1 - 2 - 3 - 4 - 1 - 2 - 3 - 4 - 1 - 2 - 3 - 4 - 1 - 2 - 3 - 4
2 - 3 - 4 - 1 - 2 - 3 - 4 - 1 - 2 - 3 - 4 - 1 - 2 - 3 - 4 - 1 - 2 - 3 - 4 - 1 - 2 - 3 - 4 - 1
- - - - - - - - - - - - - - - - - - - - - - - - - - - - - - - - - - - - - - - - - - - - - - -
b - b - b - b - b - b - b - b - b - b - b - b - b - b - b - b - b - b - b - b - b - b - b - b
1 - 2 - 3 - 4 - 1 - 2 - 3 - 4 - 1 - 2 - 3 - 4 - 1 - 2 - 3 - 4 - 1 - 2 - 3 - 4 - 1 - 2 - 3 - 4
2 - 3 - 4 - 1 - 2 - 3 - 4 - 1 - 2 - 3 - 4 - 1 - 2 - 3 - 4 - 1 - 2 - 3 - 4 - 1 - 2 - 3 - 4 - 1
- - - - - - - - - - - - - - - - - - - - - - - - - - - - - - - - - - - - - - - - - - - - - - -
b - b - b - b - b - b - b - b - b - b - b - b - b - b - b - b - b - b - b - b - b - b - b - b
1 - 2 - 3 - 4 - 1 - 2 - 3 - 4 - 1 - 2 - 3 - 4 - 1 - 2 - 3 - 4 - 1 - 2 - 3 - 4 - 1 - 2 - 3 - 4
2 - 3 - 4 - 1 - 2 - 3 - 4 - 1 - 2 - 3 - 4 - 1 - 2 - 3 - 4 - 1 - 2 - 3 - 4 - 1 - 2 - 3 - 4 - 1
- - - - - - - - - - - - - - - - - - - - - - - - - - - - - - - - - - - - - - - - - - - - - - -
b - b - b - b - b - b - b - b - b - b - b - b - b - b - b - b - b - b - b - b - b - b - b - b
1 - 2 - 3 - 4 - 1 - 2 - 3 - 4 - 1 - 2 - 3 - 4 - 1 - 2 - 3 - 4 - 1 - 2 - 3 - 4 - 1 - 2 - 3 - 4
2 - 3 - 4 - 1 - 2 - 3 - 4 - 1 - 2 - 3 - 4 - 1 - 2 - 3 - 4 - 1 - 2 - 3 - 4 - 1 - 2 - 3 - 4 - 1
- - - - - - - - - - - - - - - - - - - - - - - - - - - - - - - - - - - - - - - - - - - - - - -
b - b - b - b - b - b - b - b - b - b - b - b - b - b - b - b - b - b - b - b - b - b - b - b
1 - 2 - 3 - 4 - 1 - 2 - 3 - 4 - 1 - 2 - 3 - 4 - 1 - 2 - 3 - 4 - 1 - 2 - 3 - 4 - 1 - 2 - 3 - 4
2 - 3 - 4 - 1 - 2 - 3 - 4 - 1 - 2 - 3 - 4 - 1 - 2 - 3 - 4 - 1 - 2 - 3 - 4 - 1 - 2 - 3 - 4 - 1