4
2
2 1
21 21
c - 0 - 0 - 0 - 0 - 0 - 0 - 0 - 0 - 0 - c
- 0 0 0 0 0 0 0 0 0 0 0 0 0 0 0 0 0 0 0 -
0 0 0 0 0 0 0 0 0 0 0 0 0 0 0 0 0 0 0 0 0
- 0 0 0 4 1 0 0 0 0 0 0 0 0 0 3 4 0 0 0 -
0 0 0 0 1 4 0 0 0 0 0 0 0 0 0 4 3 0 0 0 0
- 0 0 0 0 0 0 0 0 0 0 0 0 0 0 0 0 0 0 0 -
0 0 0 0 0 0 x x 0 0 0 0 0 x x 0 0 0 0 0 0
- 0 0 0 0 0 x 0 0 0 - 0 0 0 x 0 0 0 0 0 -
0 0 0 0 0 0 0 0 0 0 - 0 0 0 0 0 0 0 0 0 0
- 0 0 0 0 0 0 0 0 i - i 0 0 0 0 0 0 0 0 -
0 0 0 0 0 0 0 - - - - - - - 0 0 0 0 0 0 0
- 0 0 0 0 0 0 0 0 i - i 0 0 0 0 0 0 0 0 -
0 0 0 0 0 0 0 0 0 0 - 0 0 0 0 0 0 0 0 0 0
- 0 0 0 0 0 x 0 0 0 - 0 0 0 x 0 0 0 0 0 -
0 0 0 0 0 0 x x 0 0 0 0 0 x x 0 0 0 0 0 0
- 0 0 0 0 0 0 0 0 0 0 0 0 0 0 0 0 0 0 0 -
0 0 0 0 1 2 0 0 0 0 0 0 0 0 0 2 3 0 0 0 0 
- 0 0 0 2 1 0 0 0 0 0 0 0 0 0 3 2 0 0 0 -
0 0 0 0 0 0 0 0 0 0 0 0 0 0 0 0 0 0 0 0 0
- 0 0 0 0 0 0 0 0 0 0 0 0 0 0 0 0 0 0 0 -
c - 0 - 0 - 0 - 0 - 0 - 0 - 0 - 0 - 0 - c