4
2
2 0
20 20
0 0 0 0 0 0 0 0 0 - - b 0 - 0 0 0 0 0 0 
0 0 0 0 0 0 0 0 0 0 0 0 0 0 0 0 0 0 0 - 
0 0 0 0 0 0 0 0 0 0 0 0 0 0 0 0 0 0 0 0 
0 0 0 0 x 0 - 0 0 0 0 - 0 0 0 0 0 0 0 0 
0 0 0 x x x 0 0 0 - 0 0 0 0 0 0 0 0 0 0 
0 0 0 0 x 0 0 0 0 0 0 0 0 0 0 0 0 0 - 0 
0 0 0 0 0 0 0 - 0 0 0 0 0 0 0 0 0 0 0 0 
0 0 0 0 0 0 0 0 0 0 - 0 - 0 0 0 0 0 0 0 
- 0 0 0 0 0 0 0 0 0 0 0 0 0 0 0 0 0 0 0 
0 0 0 0 - 0 0 0 0 0 0 0 0 3 4 0 0 0 0 c 
0 0 0 0 0 0 0 0 0 0 0 0 0 4 3 0 0 0 0 0 
0 0 0 0 0 0 0 0 - 0 0 0 0 0 0 0 0 0 0 0 
0 b 0 0 0 0 0 0 0 0 0 0 0 0 0 0 0 0 0 0 
0 0 0 0 0 0 0 0 0 0 0 0 0 0 0 0 0 0 0 0 
0 0 0 0 0 0 0 0 0 0 0 0 0 0 0 0 0 0 0 0 
0 0 0 0 - 0 0 0 0 0 0 0 0 0 0 0 0 0 0 - 
0 0 0 0 0 0 0 0 0 0 0 0 0 0 0 0 0 0 0 0 
0 0 c 0 0 1 2 0 0 0 0 0 0 0 0 0 0 0 0 0 
0 0 0 0 0 2 1 0 0 0 0 0 i 0 0 0 0 0 0 - 
0 0 0 0 0 0 0 0 0 0 0 0 0 0 0 0 0 0 0 0 
19 4 1 <-> 19 8 2
14 1 7 <-> 19 5 3
0 14 7 <-> 1 19 3
19 13 1 <-> 19 17 4
0 0 0 <-> 19 3 1
16 19 3 <-> 11 19 5
0 9 7 <-> 19 12 3
8 4 2 <-> 19 0 1
0 18 6 <-> 10 3 5
0 19 5 <-> 9 10 5
4 19 5 <-> 5 0 0
3 16 1 <-> 0 4 7
19 6 3 <-> 4 0 7
14 0 1 <-> 0 4 6
0 7 4 <-> 0 13 5
4 19 3 <-> 4 0 1
2 19 5 <-> 6 6 2
8 5 5 <-> 4 16 0
9 19 4 <-> 10 19 4
7 5 4 <-> 19 13 2
15 19 4 <-> 12 0 1
19 8 3 <-> 1 7 5
19 13 3 <-> 0 0 5
0 6 6 <-> 19 2 0
19 3 3 <-> 19 5 1
