4
5
0 3
23 23
- - - - - - - - - - - 0 - - - - - - - - - - - 
- - - - - - - - - - 0 0 0 - - - - - - - - - - 
- - - - - - - - - 0 0 0 0 0 - - - - - - - - - 
- - - - - - - - 0 0 0 c 0 0 0 - - - - - - - - 
- - - - - - - 0 1 2 0 0 0 0 0 0 - - - - - - - 
- - - - - - 0 0 2 1 0 0 0 0 0 0 0 - - - - - - 
- - - - - 0 - - - - - - - - - - - 0 - - - - - 
- - - - 0 0 - - - - - - - - - - - 0 0 - - - - 
- - - 0 0 0 - - - - - - - - - - - 2 3 0 - - - 
- - 0 0 0 0 - - - 0 0 0 0 0 - - - 3 2 0 0 - - 
- 0 0 0 0 0 - - - 0 0 0 0 0 - - - 0 0 0 0 0 - 
0 0 0 i 0 0 - - - 0 0 b 0 0 - - - 0 0 i 0 0 0 
- 0 0 0 0 0 - - - 0 0 0 0 0 - - - 0 0 0 0 0 - 
- - 0 0 4 1 - - - 0 0 0 0 0 - - - 0 0 0 0 - - 
- - - 0 1 4 - - - - - - - - - - - 0 0 0 - - - 
- - - - 0 0 - - - - - - - - - - - 0 0 - - - - 
- - - - - 0 - - - - - - - - - - - 0 - - - - - 
- - - - - - 0 0 0 0 0 0 0 3 4 0 0 - - - - - - 
- - - - - - - 0 0 0 0 0 0 4 3 0 - - - - - - - 
- - - - - - - - 0 0 0 c 0 0 0 - - - - - - - - 
- - - - - - - - - 0 0 0 0 0 - - - - - - - - - 
- - - - - - - - - - 0 0 0 - - - - - - - - - - 
- - - - - - - - - - - 0 - - - - - - - - - - - 
10 5 4 <-> 10 9 0
11 5 4 <-> 11 9 0
12 5 4 <-> 12 9 0
12 5 3 <-> 12 9 1
10 5 5 <-> 10 9 7
13 10 2 <-> 17 10 6
13 11 2 <-> 17 11 6
13 12 2 <-> 17 12 6
13 10 1 <-> 17 10 7
13 12 3 <-> 17 12 5
12 13 4 <-> 12 17 0
11 13 4 <-> 11 17 0
10 13 4 <-> 10 17 0
12 13 3 <-> 12 17 1
10 13 5 <-> 10 17 7
9 12 6 <-> 5 12 2
9 11 6 <-> 5 11 2
9 10 6 <-> 5 10 2
5 10 1 <-> 9 10 7
5 12 3 <-> 9 12 5
