4
2
2 1
29 36
- - - - - - i 0 0 0 0 0 0 0 0 0 0 0 0 0 0 0 0 0 0 0 0 - - - - - - - - - 
- - - - - - 0 0 0 0 0 0 0 0 0 0 0 0 0 0 0 0 0 0 0 0 0 - - - - - - - - - 
- - - - - - 0 0 1 2 0 0 0 0 0 0 0 0 0 0 0 0 0 0 0 0 0 - - - - - - - - - 
- - - - - - 0 0 2 1 0 0 c 0 0 0 0 0 0 0 0 0 0 0 0 0 0 0 0 0 - - - - - - 
- - - - - - 0 0 0 0 0 0 - - - - - - - - - - - 0 0 0 0 0 0 0 - - - - - - 
- - - - - - 0 0 0 0 0 - 0 0 0 0 0 0 0 0 0 0 0 - 0 0 0 0 0 0 - - - - - - 
- - - - - - 0 0 0 0 0 - 0 0 0 0 0 0 0 0 0 0 0 - 0 0 0 0 0 0 - - - - - - 
- - - - - - 0 0 0 0 - 0 - - - 0 - - - - 0 0 0 0 - 0 0 0 0 0 - - - - - - 
- - - - - - 0 0 0 0 - 0 0 b - 0 0 0 b - 0 - - 0 0 - 0 0 0 0 - - - - - - 
- - - - - - 0 0 0 0 0 - 0 - 0 0 - 0 0 0 0 0 - - 0 - 0 0 0 0 - - - - - - 
- - - - - - 0 0 0 0 0 - 0 0 - - 0 0 0 - - - 0 - 0 - 0 0 0 0 - - - - - - 
- - - - - - 0 0 0 0 0 - - - - - - - - 0 - 0 0 0 - 0 0 0 0 0 - - - - - - 
- - - - - - 0 0 0 0 0 - 0 b 0 b 0 b 0 b 0 0 0 - 0 0 0 0 0 0 - - - - - - 
- - - - - - 0 0 0 0 - 0 - - - - - - - 0 0 0 - 0 0 0 0 0 0 0 - - - - - - 
- - - - - - 0 0 0 0 - 0 0 0 0 0 0 0 0 0 - - 0 c 0 0 0 0 0 0 - - - - - - 
- - - - - - 0 0 0 0 - 0 0 0 0 0 0 - - - 0 0 0 0 0 0 0 0 0 0 - - - - - - 
- - - - - - 0 0 0 0 0 - - - - - - 0 0 0 0 0 0 0 0 0 0 0 0 0 - - - - - - 
- - - - - - 0 0 0 0 0 0 0 0 0 0 0 0 0 0 0 0 0 0 0 0 3 4 0 0 - - - - - - 
- - - - - - - - - 0 0 0 0 0 0 0 0 0 0 0 0 0 0 0 0 0 4 3 0 0 - - - - - - 
- - - - - - - - - 0 0 0 0 0 0 0 0 0 0 0 0 0 0 0 0 0 0 0 0 0 - - - - - - 
- - - - - - - - - 0 0 0 0 0 0 0 0 0 0 0 0 0 0 0 0 0 0 0 0 i - - - - - - 
- - - - - - - - - - - - - - - - - - - - - - - - - - - - - - - - - - - - 
0 0 0 0 0 0 0 0 0 0 0 0 0 0 0 0 0 0 0 0 0 0 0 0 0 0 0 0 0 0 0 0 0 0 0 0 
0 c c c 0 i i i 0 b b b 0 c c c 0 0 i 0 0 0 b b b 0 c 0 0 0 c 0 i i i 0 
0 c 0 c 0 i 0 i 0 b 0 b 0 c 0 c 0 0 i 0 0 0 b 0 0 0 c c 0 c c 0 0 0 i 0 
0 c c c 0 i i 0 0 b 0 b 0 c c c c 0 i 0 0 0 b b 0 0 c 0 c 0 c 0 0 i 0 0 
0 c 0 0 0 i 0 i 0 b 0 b 0 c 0 0 c 0 i 0 0 0 b 0 0 0 c 0 0 0 c 0 0 0 0 0 
0 c 0 0 0 i 0 i 0 b b b 0 c c c c 0 i i i 0 b b b 0 c 0 0 0 c 0 0 i 0 0 
0 0 0 0 0 0 0 0 0 0 0 0 0 0 0 0 0 0 0 0 0 0 0 0 0 0 0 0 0 0 0 0 0 0 0 0 
