4
0
3 1
20 40
- 0 0 0 0 0 0 0 0 0 - 0 0 0 0 0 0 0 0 - - 0 0 0 0 0 0 0 0 - 0 0 0 0 0 0 0 0 0 - 
0 0 0 0 0 0 0 0 0 0 - 0 0 0 0 0 0 0 0 - - 0 0 0 0 0 0 0 0 - 0 0 0 0 0 0 0 0 0 0 
0 0 x 0 0 x 0 0 0 0 - 0 0 0 0 0 0 0 0 - - 0 0 0 0 0 0 0 0 - 0 0 0 0 x 0 0 x 0 0 
0 0 0 1 3 0 - 0 0 0 0 0 0 0 0 0 i i 0 0 0 0 i i 0 0 0 0 0 0 0 0 0 - 0 2 3 0 0 0 
0 0 0 3 1 0 - 0 0 0 0 0 0 0 - 0 0 0 0 0 0 0 0 0 0 - 0 0 0 0 0 0 0 - 0 3 2 0 0 0 
0 0 x 0 0 0 - 0 0 0 0 0 0 0 - 0 0 0 0 0 0 0 0 0 0 - 0 0 0 0 0 0 0 - 0 0 0 x 0 0 
0 0 0 - - - - 0 0 0 0 0 0 0 - 0 0 0 0 0 0 0 0 0 0 - 0 0 0 0 0 0 0 - - - - 0 0 0 
0 0 0 0 0 0 0 0 0 0 0 0 i 0 0 0 0 0 0 - - 0 0 0 0 0 0 i 0 0 0 0 0 0 0 0 0 0 0 0 
0 0 0 0 0 0 0 0 0 0 - 0 0 0 0 0 0 0 - c c - 0 0 0 0 0 0 0 - 0 0 0 0 0 0 0 0 0 0 
- - - 0 0 0 0 0 0 0 - 0 0 0 0 0 0 - c c c c - 0 0 0 0 0 0 - 0 0 0 0 0 0 0 - - - 
- - - 0 0 0 0 0 0 0 - 0 0 0 0 0 0 - c c c c - 0 0 0 0 0 0 - 0 0 0 0 0 0 0 - - - 
0 0 0 0 0 0 0 0 0 0 - 0 0 0 0 0 0 0 - c c - 0 0 0 0 0 0 0 - 0 0 0 0 0 0 0 0 0 0 
0 0 0 0 0 0 0 0 0 0 0 0 i 0 0 0 0 0 0 - - 0 0 0 0 0 0 i 0 0 0 0 0 0 0 0 0 0 0 0 
0 0 0 - - - - 0 0 0 0 0 0 0 - 0 0 0 0 0 0 0 0 0 0 - 0 0 0 0 0 0 0 - - - - 0 0 0 
0 0 x 0 0 0 - 0 0 0 0 0 0 0 - 0 0 0 0 0 0 0 0 0 0 - 0 0 0 0 0 0 0 - 0 0 0 x 0 0 
0 0 0 4 2 0 - 0 0 0 0 0 0 0 - 0 0 0 0 0 0 0 0 0 0 - 0 0 0 0 0 0 0 - 0 4 1 0 0 0 
0 0 0 2 4 0 - 0 0 0 0 0 0 0 0 0 i i 0 0 0 0 i i 0 0 0 0 0 0 0 0 0 - 0 1 4 0 0 0 
0 0 x 0 0 x 0 0 0 0 - 0 0 0 0 0 0 0 0 - - 0 0 0 0 0 0 0 0 - 0 0 0 0 x 0 0 x 0 0 
0 0 0 0 0 0 0 0 0 0 - 0 0 0 0 0 0 0 0 - - 0 0 0 0 0 0 0 0 - 0 0 0 0 0 0 0 0 0 0 
- 0 0 0 0 0 0 0 0 0 - 0 0 0 0 0 0 0 0 - - 0 0 0 0 0 0 0 0 - 0 0 0 0 0 0 0 0 0 - 
32 7 1 <-> 32 12 3
7 12 5 <-> 7 7 7
19 16 4 <-> 19 3 0
20 3 0 <-> 20 16 4
28 18 2 <-> 21 18 6
18 18 2 <-> 11 18 6
11 1 6 <-> 18 1 2
21 1 6 <-> 28 1 2
