4
0
0 0
18 38
0 0 0 0 0 0 0 b 0 0 0 0 0 0 0 - 0 0 0 0 0 0 - 0 0 0 0 0 0 0 b 0 0 0 0 0 0 0 
0 0 0 0 0 0 0 0 0 0 0 0 0 0 0 - 0 0 0 0 0 0 - 0 0 0 0 0 0 0 0 0 0 0 0 0 0 0 
0 0 0 0 0 0 0 0 0 0 0 0 0 0 0 - 0 0 0 0 0 0 - 0 0 0 0 0 0 0 0 0 0 0 0 0 0 0 
0 0 0 1 2 0 0 0 - - - - - 0 0 - 0 0 b b 0 0 - 0 0 - - - - - 0 0 0 2 3 0 0 0 
0 0 0 2 1 0 0 0 - - - - - 0 0 - - - - - - - - 0 0 - - - - - 0 0 0 3 2 0 0 0 
0 0 0 0 0 0 0 0 - - b 0 0 0 0 0 0 0 - - 0 0 0 0 0 0 0 b - - 0 0 0 0 0 0 0 0 
0 0 0 0 0 0 0 0 - - 0 0 0 0 0 0 0 0 - - 0 0 0 0 0 0 0 0 - - 0 0 0 0 0 0 0 0 
0 0 0 0 0 0 0 b - - 0 0 0 0 0 0 0 0 - - 0 0 0 0 0 0 0 0 - - b 0 0 0 0 0 0 0 
- - - - - - - - - - 0 0 0 3 1 0 0 0 0 0 0 0 0 2 4 0 0 0 - - - - - - - - - - 
- - - - - - - - - - 0 0 0 1 3 0 0 0 0 0 0 0 0 4 2 0 0 0 - - - - - - - - - - 
0 0 0 0 0 0 0 b - - 0 0 0 0 0 0 0 0 - - 0 0 0 0 0 0 0 0 - - b 0 0 0 0 0 0 0 
0 0 0 0 0 0 0 0 - - 0 0 0 0 0 0 0 0 - - 0 0 0 0 0 0 0 0 - - 0 0 0 0 0 0 0 0 
0 0 0 0 0 0 0 0 - - b 0 0 0 0 0 0 0 - - 0 0 0 0 0 0 0 b - - 0 0 0 0 0 0 0 0 
0 0 0 4 1 0 0 0 - - - - - 0 0 - - - - - - - - 0 0 - - - - - 0 0 0 3 4 0 0 0 
0 0 0 1 4 0 0 0 - - - - - 0 0 - 0 0 b b 0 0 - 0 0 - - - - - 0 0 0 4 3 0 0 0 
0 0 0 0 0 0 0 0 0 0 0 0 0 0 0 - 0 0 0 0 0 0 - 0 0 0 0 0 0 0 0 0 0 0 0 0 0 0 
0 0 0 0 0 0 0 0 0 0 0 0 0 0 0 - 0 0 0 0 0 0 - 0 0 0 0 0 0 0 0 0 0 0 0 0 0 0 
0 0 0 0 0 0 0 b 0 0 0 0 0 0 0 - 0 0 0 0 0 0 - 0 0 0 0 0 0 0 b 0 0 0 0 0 0 0 
0 0 0 <-> 0 0 6
0 7 6 <-> 0 7 4
0 10 0 <-> 0 10 6
0 17 4 <-> 0 17 6
7 17 4 <-> 10 12 4
7 10 2 <-> 7 7 2
10 5 0 <-> 7 0 0
16 14 7 <-> 17 12 3
21 14 1 <-> 20 12 5
16 3 5 <-> 17 5 1
20 5 7 <-> 21 3 3
30 0 0 <-> 27 5 0
30 7 6 <-> 30 10 6
27 12 4 <-> 30 17 4
37 10 0 <-> 37 10 2
37 17 4 <-> 37 17 2
37 7 4 <-> 37 7 2
37 0 0 <-> 37 0 2
