4
4
1 3
21 25
- - - - - - - - - - - - - - - - - - - - - - - - - 
- - - - - - - - - - - - - - - - - - - - - - - - - 
- - 0 0 0 0 0 0 - - - - - - - - - - - 0 0 0 0 0 0 
- - 0 c 0 0 0 0 - - - - - - - - - - - 0 0 0 0 c 0 
- - 0 0 0 0 0 0 0 0 0 0 0 0 0 0 0 0 0 0 0 0 0 0 0 
- - 0 0 0 0 0 0 0 0 0 0 0 0 0 0 0 0 0 0 0 0 0 0 0 
- - 0 0 0 0 0 0 0 0 0 0 0 0 0 0 0 0 0 0 0 0 0 0 0 
- - 0 0 0 0 0 0 0 0 0 0 0 0 0 0 0 0 0 0 0 0 0 0 0 
- - 0 0 0 0 0 0 0 0 1 2 0 - 0 0 0 0 0 0 0 0 0 0 0 
- - 0 0 0 0 0 0 0 0 2 1 0 - 0 b 0 0 0 0 0 0 0 0 0 
- - - - b 0 0 0 0 0 0 0 0 - 0 0 0 0 0 0 0 0 b - - 
- - - - 0 i 0 0 0 0 - - - - - - - 0 0 0 0 i 0 - - 
- - - - b 0 0 0 0 0 0 0 0 - 0 0 0 0 0 0 0 0 b - - 
- - 0 0 0 0 0 0 0 0 0 b 0 - 0 3 4 0 0 0 0 0 0 0 0 
- - 0 0 0 0 0 0 0 0 0 0 0 - 0 4 3 0 0 0 0 0 0 0 0 
- - 0 0 0 0 0 0 0 0 0 0 0 0 0 0 0 0 0 0 0 0 0 0 0 
- - 0 0 0 0 0 0 0 0 0 0 0 0 0 0 0 0 0 0 0 0 0 0 0 
- - 0 0 0 0 0 0 0 0 0 0 0 0 0 0 0 0 0 0 0 0 0 0 0 
- - 0 0 0 0 0 0 0 0 0 0 0 0 0 0 0 0 0 0 0 0 0 0 0 
- - 0 c 0 0 0 - - - - - - - - - - - - - 0 0 0 c 0 
- - 0 0 0 0 0 - - - - - - - - - - - - - 0 0 0 0 0 
20 18 5 <-> 7 18 3
7 4 1 <-> 19 4 7
2 20 5 <-> 2 2 7
24 2 1 <-> 24 20 3
9 11 2 <-> 13 7 4
17 11 6 <-> 13 15 0
