4
4
2 4
43 43
- - - - - - - - - - - - - - - - - 0 0 0 0 0 0 0 0 0 - - - - - - - - - - - - - - - - - 
- - - - - - - - - - - - - - 0 0 0 0 0 0 0 0 0 0 0 0 0 0 0 - - - - - - - - - - - - - - 
- - - - - - - - - - - 0 0 0 0 0 0 0 0 0 0 0 0 0 0 0 0 0 0 0 0 0 - - - - - - - - - - - 
- - - - - - - - - - 0 0 0 0 0 0 0 0 0 0 3 4 0 0 0 0 0 0 0 0 0 0 0 - - - - - - - - - - 
- - - - - - - - 0 0 0 0 0 0 0 0 0 0 0 0 4 3 0 0 0 0 0 0 0 0 0 0 0 0 0 - - - - - - - - 
- - - - - - - 0 0 0 0 0 0 0 0 0 0 0 0 0 0 0 0 0 0 0 0 0 0 0 0 0 0 0 0 0 - - - - - - - 
- - - - - - 0 0 0 0 0 0 0 0 0 0 0 0 0 0 0 0 0 0 0 0 0 0 0 0 0 0 0 0 0 0 0 - - - - - - 
- - - - - 0 0 b 0 0 0 0 0 0 0 0 0 0 0 0 0 0 0 0 0 0 0 0 0 0 0 0 0 0 0 c 0 0 - - - - - 
- - - - 0 0 0 0 0 0 0 0 0 0 0 0 0 0 0 0 0 0 0 0 0 0 0 0 0 0 0 0 0 0 0 0 0 0 0 - - - - 
- - - - 0 0 0 0 0 0 - - - - - - - - - - - - - - - - - - - - - - - 0 0 0 0 0 0 - - - - 
- - - 0 0 0 0 0 0 - - - - - - - - - - - - - - - - - - - - - - - - - 0 0 0 0 0 0 - - - 
- - 0 0 0 0 0 0 0 - - 0 0 0 0 0 0 0 0 0 0 0 0 0 0 0 0 0 0 0 0 0 - - 0 0 0 0 0 0 0 - - 
- - 0 0 0 0 0 0 0 - - 0 0 0 0 0 0 0 0 0 0 0 0 0 0 0 0 0 0 0 0 0 - - 0 0 0 0 0 0 0 - - 
- - 0 0 0 0 0 0 0 - - 0 0 0 0 0 0 0 0 0 0 0 0 0 0 0 0 0 0 0 0 0 - - 0 0 0 0 0 0 0 - - 
- 0 0 0 0 0 0 0 0 - - 0 0 0 0 0 0 0 0 0 1 2 0 0 0 0 0 0 0 0 0 0 - - 0 0 0 0 0 0 0 0 - 
- 0 0 0 0 0 0 0 0 - - 0 0 0 0 0 0 0 0 0 2 1 0 0 0 0 0 0 0 0 0 0 - - 0 0 0 0 0 0 0 0 - 
- 0 0 0 0 0 0 0 0 - - 0 0 0 0 0 0 0 0 0 0 0 0 0 0 0 0 0 0 0 0 0 - - 0 0 0 0 0 0 0 0 - 
0 0 0 0 0 0 0 0 0 - - 0 0 0 0 0 0 0 0 0 0 0 0 0 0 0 0 0 0 0 0 0 - - 0 0 0 0 0 0 0 0 0 
0 0 0 0 0 0 0 0 0 - - 0 0 0 0 0 0 0 0 0 0 0 0 0 0 0 0 0 0 0 0 0 - - 0 0 0 0 0 0 0 0 0 
0 0 0 0 0 0 0 0 0 - - 0 0 0 0 0 0 0 0 0 0 0 0 0 0 0 0 0 0 0 0 0 - - 0 0 0 0 0 0 0 0 0 
0 0 0 0 0 0 0 0 0 - - 0 0 0 0 0 0 0 0 0 b b 0 0 0 0 0 0 0 0 0 0 - - 0 0 0 0 1 2 0 0 0 
0 0 0 1 2 0 0 0 0 - - 0 0 c 0 0 0 0 0 b i i b 0 0 0 0 0 0 c 0 0 - - 0 0 0 0 2 1 0 0 0 
0 0 0 2 1 0 0 0 0 - - 0 0 0 0 0 0 0 0 0 b b 0 0 0 0 0 0 0 0 0 0 - - 0 0 0 0 0 0 0 0 0 
0 0 0 0 0 0 0 0 0 - - 0 0 0 0 0 0 0 0 0 0 0 0 0 0 0 0 0 0 0 0 0 - - 0 0 0 0 0 0 0 0 0 
0 0 0 0 0 0 0 0 0 - - 0 0 0 0 0 0 0 0 0 0 0 0 0 0 0 0 0 0 0 0 0 - - 0 0 0 0 0 0 0 0 0 
0 0 0 0 0 0 0 0 0 - - 0 0 0 0 0 0 0 0 0 0 0 0 0 0 0 0 0 0 0 0 0 - - 0 0 0 0 0 0 0 0 0 
- 0 0 0 0 0 0 0 0 - - 0 0 0 0 0 0 0 0 0 0 0 0 0 0 0 0 0 0 0 0 0 - - 0 0 0 0 0 0 0 0 - 
- 0 0 0 0 0 0 0 0 - - 0 0 0 0 0 0 0 0 0 3 4 0 0 0 0 0 0 0 0 0 0 - - 0 0 0 0 0 0 0 0 - 
- 0 0 0 0 0 0 0 0 - - 0 0 0 0 0 0 0 0 0 4 3 0 0 0 0 0 0 0 0 0 0 - - 0 0 0 0 0 0 0 0 - 
- - 0 0 0 0 0 0 0 - - 0 0 0 0 0 0 0 0 0 0 0 0 0 0 0 0 0 0 0 0 0 - - 0 0 0 0 0 0 0 - - 
- - 0 0 0 0 0 0 0 - - 0 0 0 0 0 0 0 0 0 0 0 0 0 0 0 0 0 0 0 0 0 - - 0 0 0 0 0 0 0 - - 
- - 0 0 0 0 0 0 0 - - 0 0 0 0 0 0 0 0 0 0 0 0 0 0 0 0 0 0 0 0 0 - - 0 0 0 0 0 0 0 - - 
- - - 0 0 0 0 0 0 - - - - - - - - - - - - - - - - - - - - - - - - - 0 0 0 0 0 0 - - - 
- - - - 0 0 0 0 0 0 - - - - - - - - - - - - - - - - - - - - - - - 0 0 0 0 0 0 - - - - 
- - - - 0 0 0 0 0 0 0 0 0 0 0 0 0 0 0 0 0 0 0 0 0 0 0 0 0 0 0 0 0 0 0 0 0 0 0 - - - - 
- - - - - 0 0 c 0 0 0 0 0 0 0 0 0 0 0 0 0 0 0 0 0 0 0 0 0 0 0 0 0 0 0 b 0 0 - - - - - 
- - - - - - 0 0 0 0 0 0 0 0 0 0 0 0 0 0 0 0 0 0 0 0 0 0 0 0 0 0 0 0 0 0 0 - - - - - - 
- - - - - - - 0 0 0 0 0 0 0 0 0 0 0 0 0 0 0 0 0 0 0 0 0 0 0 0 0 0 0 0 0 - - - - - - - 
- - - - - - - - 0 0 0 0 0 0 0 0 0 0 0 0 0 3 4 0 0 0 0 0 0 0 0 0 0 0 0 - - - - - - - - 
- - - - - - - - - - 0 0 0 0 0 0 0 0 0 0 0 4 3 0 0 0 0 0 0 0 0 0 0 - - - - - - - - - - 
- - - - - - - - - - - 0 0 0 0 0 0 0 0 0 0 0 0 0 0 0 0 0 0 0 0 0 - - - - - - - - - - - 
- - - - - - - - - - - - - - 0 0 0 0 0 0 0 0 0 0 0 0 0 0 0 - - - - - - - - - - - - - - 
- - - - - - - - - - - - - - - - - 0 0 0 0 0 0 0 0 0 - - - - - - - - - - - - - - - - - 
9 9 3 <-> 11 11 7
31 11 1 <-> 33 9 5
33 33 7 <-> 31 31 3
9 33 1 <-> 11 31 5
8 30 2 <-> 11 30 6
11 29 6 <-> 8 29 2
8 28 2 <-> 11 28 6
11 27 6 <-> 8 27 2
11 26 6 <-> 8 26 2
11 25 6 <-> 8 25 2
11 24 6 <-> 8 24 2
11 23 6 <-> 8 23 2
8 22 2 <-> 11 22 6
11 21 6 <-> 8 21 2
8 20 2 <-> 11 20 6
8 19 2 <-> 11 19 6
8 18 2 <-> 11 18 6
11 17 6 <-> 8 17 2
11 16 6 <-> 8 16 2
8 15 2 <-> 11 15 6
11 14 6 <-> 8 14 2
11 13 6 <-> 8 13 2
8 12 2 <-> 11 12 6
12 11 0 <-> 12 8 4
13 11 0 <-> 13 8 4
14 11 0 <-> 14 8 4
15 11 0 <-> 15 8 4
16 11 0 <-> 16 8 4
17 11 0 <-> 17 8 4
18 11 0 <-> 18 8 4
19 11 0 <-> 19 8 4
20 11 0 <-> 20 8 4
21 11 0 <-> 21 8 4
22 11 0 <-> 22 8 4
23 11 0 <-> 23 8 4
24 11 0 <-> 24 8 4
25 11 0 <-> 25 8 4
26 11 0 <-> 26 8 4
27 11 0 <-> 27 8 4
28 11 0 <-> 28 8 4
29 11 0 <-> 29 8 4
30 11 0 <-> 30 8 4
31 12 2 <-> 34 12 6
31 13 2 <-> 34 13 6
34 14 6 <-> 31 14 2
31 15 2 <-> 34 15 6
34 16 6 <-> 31 16 2
34 17 6 <-> 31 17 2
34 18 6 <-> 31 18 2
34 19 6 <-> 31 19 2
34 20 6 <-> 31 20 2
34 21 6 <-> 31 21 2
34 22 6 <-> 31 22 2
31 23 2 <-> 34 23 6
34 24 6 <-> 31 24 2
31 25 2 <-> 34 25 6
34 26 6 <-> 31 26 2
34 27 6 <-> 31 27 2
34 28 6 <-> 31 28 2
34 29 6 <-> 31 29 2
34 30 6 <-> 31 30 2
30 31 4 <-> 30 34 0
29 34 0 <-> 29 31 4
28 34 0 <-> 28 31 4
27 34 0 <-> 27 31 4
26 34 0 <-> 26 31 4
25 34 0 <-> 25 31 4
24 34 0 <-> 24 31 4
23 34 0 <-> 23 31 4
22 34 0 <-> 22 31 4
21 34 0 <-> 21 31 4
20 34 0 <-> 20 31 4
19 34 0 <-> 19 31 4
18 34 0 <-> 18 31 4
17 34 0 <-> 17 31 4
16 34 0 <-> 16 31 4
15 34 0 <-> 15 31 4
14 34 0 <-> 14 31 4
13 34 0 <-> 13 31 4
12 31 4 <-> 12 34 0
