4
2
0 2
25 25
0 0 0 0 0 x x x 0 0 0 0 0 0 0 0 0 x x x 0 0 0 0 0
0 0 0 0 0 0 0 0 0 - - 0 0 0 - - 0 0 0 0 0 0 0 0 0
0 0 0 0 0 0 0 0 - - 0 0 0 0 0 - - 0 0 0 0 0 0 0 0
0 0 0 0 0 0 0 0 0 0 0 0 b 0 0 0 0 0 0 0 0 0 0 0 0
0 0 0 0 - - - - 0 0 0 0 0 0 0 0 0 - - - - 0 0 0 0
0 0 0 0 - 0 0 0 0 0 0 0 0 0 0 0 0 0 0 0 - 0 0 0 0
0 0 0 0 - 0 x 0 - 0 0 0 0 0 0 0 - 0 x 0 - 0 0 0 0
0 0 0 0 - 0 0 0 - 0 0 0 0 0 0 0 - 0 0 0 - 0 0 0 0
0 0 0 0 0 0 - - - 0 0 0 0 0 0 0 - - - 0 0 0 0 0 0
0 0 0 0 0 0 0 0 0 0 0 0 0 0 0 0 0 0 0 0 0 0 0 0 0
x 0 0 0 - 0 0 0 0 0 0 0 0 0 0 0 0 0 0 0 - 0 0 0 x
x 0 0 0 - - 0 0 0 2 1 0 0 0 3 4 0 0 0 - - 0 0 0 x
0 0 0 0 0 - 0 0 0 1 2 0 0 0 4 3 0 0 0 - 0 0 0 0 0
0 0 0 b 0 - 0 0 0 0 0 0 0 0 0 0 0 0 0 - 0 b 0 0 0
0 0 0 0 0 0 0 0 0 0 0 0 0 0 0 0 0 0 0 0 0 0 0 0 0
0 0 0 0 0 0 0 0 0 0 0 0 0 0 0 0 0 0 0 0 0 0 0 0 0
0 0 0 0 0 0 0 0 0 0 0 0 0 0 0 0 0 0 0 0 0 0 0 0 0
0 0 0 - 0 0 0 0 - - 0 - 0 - 0 - - 0 0 0 0 - 0 0 0
0 0 0 - - 0 0 - - 0 0 - 0 - 0 0 - - 0 0 - - 0 0 0
0 0 0 0 - - - - 0 0 - 0 0 0 - 0 0 - - - - 0 0 0 0
0 0 0 - 0 - - 0 0 0 0 0 b 0 0 0 0 0 - - 0 - 0 0 0
0 0 0 0 0 0 0 0 0 0 0 0 0 0 0 0 0 0 0 0 0 0 0 0 0
0 0 0 0 0 0 0 0 0 0 0 0 0 0 0 0 0 0 0 0 0 0 0 0 0
0 0 0 0 0 0 0 0 0 0 0 0 0 0 0 0 0 0 0 0 0 0 0 0 0
0 0 0 0 0 0 0 0 x x x x 0 x x x x 0 0 0 0 0 0 0 0
9 0 0 <-> 9 24 4
10 0 0 <-> 10 24 4
11 0 0 <-> 11 24 4
12 0 0 <-> 12 24 4
13 0 0 <-> 13 24 4
14 0 0 <-> 14 24 4
15 0 0 <-> 15 24 4
0 9 6 <-> 24 9 2
0 10 6 <-> 24 10 2
0 11 6 <-> 24 11 2
0 12 6 <-> 24 12 2
0 13 6 <-> 24 13 2
0 14 6 <-> 24 14 2
0 15 6 <-> 24 15 2