4
3
2 1
21 26
- - - - - - - - - - - - - - - - - - - - - - - - - - 
- - - - - - - - - - - - - - 0 0 0 0 - - - - - - - - 
- - - - - - - - - - - - - 0 0 0 0 0 0 - - - - - - - 
- - - - - - - - - - - - - 0 0 0 0 0 0 - - - - - - - 
- - - - - - - - - - - - - x 0 2 3 0 x - - - - - - - 
- - - - - - - - - - - - - x 0 3 2 0 x - - - - - - - 
- - - - - - - - - - - - - 0 0 0 0 0 0 - - - - - - - 
- - - - - - - - - - - - - 0 0 0 0 0 0 - - - - - - - 
- - - - - - - 0 0 x x 0 0 0 0 x x 0 0 0 0 x x 0 0 - 
- - - - - - 0 0 0 0 0 0 0 0 0 0 0 0 0 0 0 0 0 0 0 0 
- - - - - - 0 0 0 3 4 0 0 x 0 c x 0 x 0 0 1 2 0 0 0 
- - - - - - 0 0 0 4 3 0 0 x 0 x i 0 x 0 0 2 1 0 0 0 
- - - - - - 0 0 0 0 0 0 0 0 0 0 0 0 0 0 0 0 0 0 0 0 
- - - - - - - 0 0 x x 0 0 0 0 x x 0 0 0 0 x x 0 0 - 
- - - - - - - - - - - - - 0 0 0 0 0 0 - - - - - - - 
- - - - - - - - - - - - - 0 0 0 0 0 0 - - - - - - - 
- - - - - - - - - - - - - x 0 4 1 0 x - - - - - - - 
- - - - - - - - - - - - - x 0 1 4 0 x - - - - - - - 
- - - - - - - - - - - - - 0 0 0 0 0 0 - - - - - - - 
- - - - - - - - - - - - - 0 0 0 0 0 0 - - - - - - - 
- - - - - - - - - - - - - - 0 0 0 0 - - - - - - - - 
18 19 4 <-> 18 2 0
13 19 4 <-> 13 2 0
7 13 6 <-> 24 13 2
7 8 6 <-> 24 8 2
7 13 3 <-> 13 19 7
18 19 1 <-> 24 13 5
7 8 1 <-> 13 2 5
18 2 3 <-> 24 8 7
