4
7
0 0
44 40
0 0 0 0 0 0 0 0 0 0 0 0 0 0 0 0 0 0 0 0 - - - - - - - - - - - 0 0 0 0 0 0 0 0 0 
0 0 0 0 0 0 0 0 0 0 0 0 0 0 0 0 4 1 0 0 - - - - - - - - - - - 0 0 0 0 0 0 0 0 0 
0 0 2 3 0 0 0 0 0 0 0 0 0 0 0 0 1 4 0 0 - - - - - - - - - - - 0 0 0 0 0 0 0 0 0 
0 0 3 2 0 0 0 0 0 0 0 0 0 0 0 0 0 0 0 0 - - - - - - - - - - - 0 0 0 0 0 0 0 0 0 
0 0 0 0 0 0 0 0 0 0 0 0 0 0 0 0 0 0 0 0 - - - - - - - - - - - 0 0 0 0 0 0 0 0 0 
0 0 0 0 0 0 0 0 0 0 0 0 0 0 0 0 0 0 0 0 - - - - - - - - - - - 0 0 0 0 0 0 0 0 0 
0 0 0 0 0 0 0 0 0 0 0 0 0 0 0 0 0 0 0 0 - - - c 0 b - - - - - 0 0 0 0 0 0 0 0 0 
0 0 0 0 0 0 0 0 0 0 0 0 0 0 0 0 0 0 0 0 - - - 0 i 0 - - - - - 0 0 0 0 0 0 0 0 0 
0 0 0 0 0 0 0 0 0 0 0 0 0 0 0 0 0 0 0 0 - - - b 0 0 - - - - - 0 0 0 0 0 0 0 0 0 
0 0 0 0 0 0 0 0 0 0 0 0 0 0 0 0 0 0 0 0 - - - - - - 0 0 0 0 0 - - - - - - - - - 
0 0 0 0 0 0 0 0 0 0 0 0 0 0 0 0 0 0 0 0 - - - - - - 0 0 0 0 0 - - - - - - - - - 
0 0 0 0 0 0 0 0 0 0 0 0 0 0 0 0 0 0 0 0 - - - - - - 0 0 b 0 0 - - - - - - - - - 
0 0 0 0 0 0 0 0 0 0 0 0 0 0 0 0 0 0 0 0 - - - - - - 0 0 0 0 0 - - - - - - - - - 
0 0 0 0 0 0 0 0 0 0 0 0 0 0 0 0 0 0 0 0 - - - - - - 0 0 0 0 0 - - - - - - - - - 
0 0 0 0 0 0 0 0 0 0 0 0 0 0 0 0 0 0 0 0 - - - b 0 0 - - - - - 0 0 b - - - - - - 
0 0 0 0 0 0 0 0 0 0 0 0 0 0 0 0 0 0 0 0 - - - 0 i 0 - - - - - 0 i 0 - - - - - - 
0 0 0 0 0 0 0 0 0 0 0 0 0 0 0 0 0 0 0 0 - - - c 0 b - - - - - b 0 c - - - - - - 
0 0 0 0 0 0 0 0 0 0 0 0 0 0 0 0 0 0 0 0 - - - - - - - - - - - - - - - - - - - - 
0 0 4 1 0 0 0 0 0 0 0 0 0 0 0 0 2 3 0 0 - - - - - - - - - - - - - - - - - - - - 
0 0 1 4 0 0 0 0 0 0 0 0 0 0 0 0 3 2 0 0 - - - - - - - - - - - - - - - - - - - - 
0 0 0 0 0 0 0 0 0 0 0 0 0 0 0 0 0 0 0 0 - - - - - - - - - - - - - - - - - - - - 
0 0 0 0 0 0 0 0 0 0 0 0 0 0 0 0 0 0 0 0 - - - - - - - - - - - - - - - - - - - - 
- - - - - - - - - - - - - - - - - - - - 0 0 0 0 0 0 0 0 0 0 0 0 0 0 0 0 0 0 0 0 
- - - - - - - - - - - - - - - - - - - - 0 0 0 0 0 0 0 0 0 0 0 0 0 0 0 0 0 0 0 0 
- - - - - - - - - - - - - - - - - - - - 0 0 4 1 0 0 0 0 0 0 0 0 0 0 0 0 2 3 0 0 
- - - - - - - - - - - - - - - - - - - - 0 0 1 4 0 0 0 0 0 0 0 0 0 0 0 0 3 2 0 0 
- - - - - - - - - - - - - - - - - - - - 0 0 0 0 0 0 0 0 0 0 0 0 0 0 0 0 0 0 0 0 
- - - - - - b 0 c - - - - - c 0 b - - - 0 0 0 0 0 0 0 0 0 0 0 0 0 0 0 0 0 0 0 0 
- - - - - - 0 i 0 - - - - - 0 i 0 - - - 0 0 0 0 0 0 0 0 0 0 0 0 0 0 0 0 0 0 0 0 
- - - - - - c 0 0 - - - - - 0 0 c - - - 0 0 0 0 0 0 0 0 0 0 0 0 0 0 0 0 0 0 0 0 
- - - - - - - - - 0 0 0 0 0 - - - - - - 0 0 0 0 0 0 0 0 0 0 0 0 0 0 0 0 0 0 0 0 
- - - - - - - - - 0 0 0 0 0 - - - - - - 0 0 0 0 0 0 0 0 0 0 0 0 0 0 0 0 0 0 0 0 
- - - - - - - - - 0 0 b 0 0 - - - - - - 0 0 0 0 0 0 0 0 0 0 0 0 0 0 0 0 0 0 0 0 
- - - - - - - - - 0 0 0 0 0 - - - - - - 0 0 0 0 0 0 0 0 0 0 0 0 0 0 0 0 0 0 0 0 
- - - - - - - - - 0 0 0 0 0 - - - - - - 0 0 0 0 0 0 0 0 0 0 0 0 0 0 0 0 0 0 0 0 
0 0 0 0 0 0 0 0 0 - - - - - 0 0 c - - - 0 0 0 0 0 0 0 0 0 0 0 0 0 0 0 0 0 0 0 0 
0 0 0 0 0 0 0 0 0 - - - - - 0 i 0 - - - 0 0 0 0 0 0 0 0 0 0 0 0 0 0 0 0 0 0 0 0 
0 0 0 0 0 0 0 0 0 - - - - - c 0 b - - - 0 0 0 0 0 0 0 0 0 0 0 0 0 0 0 0 0 0 0 0 
0 0 0 0 0 0 0 0 0 - - - - - - - - - - - 0 0 0 0 0 0 0 0 0 0 0 0 0 0 0 0 0 0 0 0 
0 0 0 0 0 0 0 0 0 - - - - - - - - - - - 0 0 0 0 0 0 0 0 0 0 0 0 0 0 0 0 0 0 0 0 
0 0 0 0 0 0 0 0 0 - - - - - - - - - - - 0 0 2 3 0 0 0 0 0 0 0 0 0 0 0 0 4 1 0 0 
0 0 0 0 0 0 0 0 0 - - - - - - - - - - - 0 0 3 2 0 0 0 0 0 0 0 0 0 0 0 0 1 4 0 0 
0 0 0 0 0 0 0 0 0 - - - - - - - - - - - 0 0 0 0 0 0 0 0 0 0 0 0 0 0 0 0 0 0 0 0 
0 0 0 0 0 0 0 0 0 - - - - - - - - - - - 0 0 0 0 0 0 0 0 0 0 0 0 0 0 0 0 0 0 0 0 
0 21 4 <-> 0 35 0
19 0 2 <-> 31 0 6
39 8 4 <-> 39 22 0
20 43 6 <-> 8 43 2
6 35 0 <-> 9 32 6
8 37 2 <-> 11 34 4
9 30 0 <-> 8 29 2
8 28 2 <-> 10 30 0
8 29 4 <-> 9 30 6
7 29 4 <-> 9 31 6
13 30 0 <-> 14 29 6
12 30 0 <-> 14 28 6
13 31 2 <-> 15 29 4
13 34 4 <-> 14 35 6
13 33 2 <-> 15 35 0
12 34 4 <-> 14 36 6
8 36 2 <-> 10 34 4
9 33 6 <-> 7 35 0
8 41 2 <-> 20 41 6
8 39 2 <-> 20 39 6
8 38 2 <-> 39 38 2
39 40 2 <-> 8 40 2
8 42 2 <-> 39 42 2
2 21 4 <-> 2 35 0
4 35 0 <-> 4 21 4
1 35 0 <-> 1 0 0
3 0 0 <-> 3 35 0
5 35 0 <-> 5 0 0
25 14 0 <-> 26 13 6
26 13 4 <-> 25 14 2
27 13 4 <-> 25 15 2
26 12 6 <-> 24 14 0
30 13 4 <-> 31 14 6
30 13 2 <-> 31 14 0
29 13 4 <-> 31 15 6
32 14 0 <-> 30 12 2
25 8 2 <-> 26 9 0
25 8 4 <-> 26 9 6
24 8 4 <-> 26 10 6
25 7 2 <-> 27 9 0
29 9 0 <-> 31 7 6
31 6 6 <-> 28 9 0
32 8 4 <-> 30 10 2
33 8 4 <-> 30 11 2
37 8 4 <-> 37 22 0
35 8 4 <-> 35 22 0
38 8 4 <-> 38 43 4
36 43 4 <-> 36 8 4
34 43 4 <-> 34 8 4
19 2 2 <-> 31 2 6
31 4 6 <-> 19 4 2
31 1 6 <-> 0 1 6
31 3 6 <-> 0 3 6
31 5 6 <-> 0 5 6
11 30 7 <-> 6 27 7
11 30 1 <-> 16 27 1
26 11 7 <-> 23 6 7
28 13 5 <-> 23 16 5
28 13 3 <-> 33 16 3
26 11 5 <-> 13 32 1
19 11 3 <-> 28 22 7
19 11 1 <-> 28 22 1
11 21 5 <-> 20 32 5
20 32 7 <-> 11 21 3
24 22 7 <-> 15 21 3
19 15 3 <-> 20 28 7
20 28 5 <-> 19 15 1
24 22 1 <-> 15 21 5
14 29 4 <-> 13 30 2
13 34 2 <-> 14 35 0
16 37 3 <-> 13 32 3
