4
6
2 3
35 24 
- - - - - - - - - - - - - - - - - - - - - - - -
0 0 0 0 0 0 0 0 0 0 0 0 0 0 0 0 0 0 0 0 - - - -
- 0 0 0 0 0 0 0 0 0 0 0 0 0 0 0 0 0 c 0 0 - - -
- - 0 0 0 0 0 0 - - 0 0 0 0 - - 0 0 0 0 0 0 - -
- - - 0 0 0 0 - - - - 0 0 - - - - 0 0 0 0 - - -
- - - 0 0 0 0 - - - - 0 0 - - - - 0 0 0 0 - - -
- - 0 0 0 0 0 0 - - 0 0 0 0 - - 0 0 0 0 0 0 - -
- 0 0 1 2 3 4 0 0 0 0 0 0 0 0 0 0 0 0 0 0 - - -
0 0 0 4 1 2 3 0 0 0 0 0 0 0 0 0 0 0 0 0 - - - -
0 0 0 3 4 1 2 0 0 0 0 0 0 0 0 0 0 0 c 0 - - - -
- 0 0 2 3 4 1 0 0 0 0 0 0 0 0 0 0 0 0 0 0 - - -
- - 0 0 0 0 0 0 - - 0 0 0 0 - - 0 0 0 0 0 0 - -
- - - 0 0 0 0 - - - - 0 0 - - - - 0 0 0 0 - - -
- - - 0 0 0 0 - - - - 0 0 - - - - 0 0 0 0 - - -
- - 0 0 0 0 0 0 - - 0 0 0 0 - - 0 0 0 0 0 0 - -
- 0 0 0 0 0 0 0 0 0 1 2 3 4 0 0 0 0 0 0 0 - - -
0 0 0 0 0 0 0 0 0 0 4 1 2 3 0 0 0 0 0 0 - - - -
0 0 0 0 0 0 0 0 0 0 3 4 1 2 0 0 0 0 0 0 - - - -
- 0 0 0 0 0 0 0 0 0 2 3 4 1 0 0 0 0 0 0 0 - - -
- - 0 0 0 0 0 0 - - 0 0 0 0 - - 0 0 0 0 0 0 - -
- - - 0 0 0 0 - - - - 0 0 - - - - 0 0 0 0 - - -
- - - 0 0 0 0 - - - - 0 0 - - - - 0 0 0 0 - - -
- - 0 0 0 0 0 0 - - 0 0 0 0 - - 0 0 0 0 0 0 - -
- 0 0 0 0 0 0 0 0 0 0 0 0 0 0 0 0 0 0 0 0 - - -
0 0 0 0 0 0 0 0 0 b 0 0 0 0 0 0 0 0 0 0 - - - -
0 0 0 0 0 0 0 0 0 0 0 0 0 0 0 0 0 0 0 - - - - -
0 0 i i 0 0 0 0 0 0 0 0 0 0 0 0 0 0 - - - - - -
0 0 i i 0 0 0 0 0 b 0 0 0 0 0 0 0 - - - - - - -
0 0 0 0 0 0 0 0 0 0 0 0 0 0 0 0 - - - - - - - -
0 0 0 0 0 0 0 0 0 0 0 0 0 0 0 - - - - - - - - -
0 0 0 0 0 0 0 0 0 0 0 0 0 0 - - - - - - - - - -
0 0 0 0 0 0 0 0 0 0 0 0 0 - - - - - - - - - - -
0 0 0 0 0 0 0 0 0 0 0 0 - - - - - - - - - - - -
0 0 0 0 0 0 0 0 c 0 0 - - - - - - - - - - - - -
0 0 0 0 0 0 0 0 0 0 - - - - - - - - - - - - - -