4
6
7 2
41 41
- - - - i x 0 0 0 0 0 0 0 0 0 0 0 0 0 0 0 0 0 0 0 0 0 0 0 0 0 0 0 0 0 x i - - - - 
- - - - x x - 0 0 0 0 0 1 2 0 0 0 0 0 0 0 0 0 0 0 0 0 3 4 0 0 0 0 0 - x x - - - - 
- - - - 0 - 0 0 0 0 0 0 2 1 0 0 0 0 0 0 0 0 0 0 0 0 0 4 3 0 0 0 0 0 0 - 0 - - - - 
- - - - 0 0 0 0 0 0 0 0 0 0 0 0 0 0 0 0 0 0 0 0 0 0 0 0 0 0 0 0 0 0 0 0 0 - - - - 
- - - - 0 0 0 0 0 0 0 - 0 - 0 - 0 - 0 - c - 0 - 0 - 0 - 0 - 0 0 0 0 0 0 0 - - - - 
- - - - 0 0 0 0 0 0 - 0 0 0 0 0 0 0 0 0 0 0 0 0 0 0 0 0 0 0 - 0 0 0 0 0 0 - - - - 
- - - - 0 0 0 0 0 - 0 0 0 0 0 0 0 0 0 0 0 0 0 0 0 0 0 0 0 0 0 - 0 0 0 0 0 - - - - 
- - - - 0 0 0 0 - 0 0 0 0 0 0 0 0 0 0 0 0 0 0 0 0 0 0 0 0 0 0 0 - 0 0 0 0 - - - - 
- - - - 0 0 0 - 0 0 0 0 0 0 0 0 0 0 0 0 0 0 0 0 0 0 0 0 0 0 0 0 0 - 0 0 0 - - - - 
- - - - 0 0 0 0 0 0 0 0 0 0 0 0 0 0 0 0 - 0 0 0 0 0 0 0 0 0 0 0 0 0 0 0 0 - - - - 
- - - - - 0 0 0 0 c 0 0 0 x 0 0 0 0 - - - - - 0 0 0 0 x 0 0 0 c 0 0 0 0 - - - - - 
- - - - - - - - - 0 0 x 0 0 0 x 0 0 0 - - - 0 0 0 x 0 0 0 x 0 0 - - - - - - - - - 
- - - - - - - - 0 0 0 0 0 0 0 0 0 0 0 0 - 0 0 0 0 0 0 0 0 0 0 0 0 - - - - - - - - 
- - - - - - - 0 0 0 x 0 0 x 0 0 x 0 0 0 c 0 0 0 x 0 0 x 0 0 x 0 0 0 - - - - - - - 
- - - - - - 0 0 0 0 0 0 0 0 0 0 0 0 0 0 - 0 0 0 0 0 0 0 0 0 0 0 0 0 0 - - - - - - 
- - - - - 0 0 0 0 0 0 x 0 0 0 x 0 0 0 - - - 0 0 0 x 0 0 0 x 0 0 0 0 0 0 - - - - - 
- - - - 0 0 0 0 0 0 0 0 0 x 0 0 0 0 - - - - - 0 0 0 0 x 0 0 0 0 0 0 0 0 0 - - - - 
- - - 0 0 0 0 0 0 0 0 0 0 0 0 0 0 0 0 0 - 0 0 0 0 0 0 0 0 0 0 0 0 0 0 0 0 0 - - - 
b 0 0 0 0 0 0 b 0 0 0 0 0 0 0 0 0 0 0 0 0 0 0 0 0 0 0 0 0 0 0 0 0 b 0 0 0 0 0 0 b 
0 0 0 0 0 0 0 0 0 0 0 0 0 0 0 0 0 0 0 0 0 0 0 0 0 0 0 0 0 0 0 0 0 0 0 0 0 0 0 0 0 
0 0 0 0 0 0 0 0 0 0 0 0 0 0 0 0 0 0 0 0 0 0 0 0 0 0 0 0 0 0 0 0 0 0 0 0 0 0 0 0 0 
0 0 0 0 0 0 0 0 0 x 0 0 0 x 0 0 0 x 0 0 0 0 0 x 0 0 0 x 0 0 0 x 0 0 0 0 0 0 0 0 0 
0 0 0 0 0 0 0 0 0 0 - - - - - - - 0 0 0 - 0 0 0 - - - - - - - 0 0 0 0 0 0 0 0 0 0 
0 0 0 0 0 0 0 0 0 0 - - - - - - - 0 0 - 0 - 0 0 - - - - - - - 0 0 0 0 0 0 0 0 0 0 
0 0 0 0 0 0 0 0 0 0 - - 0 0 0 - - 0 - 0 b 0 - 0 - - 0 0 0 - - 0 0 0 0 0 0 0 0 0 0 
0 0 0 0 0 0 0 0 0 x - - 0 b 0 - - x 0 - 0 - 0 x - - 0 b 0 - - x 0 0 0 0 0 0 0 0 0 
- 0 0 0 0 0 0 0 0 0 - - 0 0 0 - - 0 0 0 - 0 0 0 - - 0 0 0 - - 0 0 0 0 0 0 0 0 0 - 
- - 0 0 0 0 0 0 0 0 - - - - - - - 0 0 - 0 - 0 0 - - - - - - - 0 0 0 0 0 0 0 0 - - 
- - - 0 0 0 0 0 0 0 - - - - - - - 0 0 0 - 0 0 0 - - - - - - - 0 0 0 0 0 0 0 - - - 
- - - - 0 0 0 0 0 x 0 0 0 x 0 0 0 x 0 0 0 0 0 x 0 0 0 x 0 0 0 x 0 0 0 0 0 - - - - 
- - - - - 0 0 0 0 0 0 0 0 0 0 0 0 0 0 - 0 - 0 0 0 0 0 0 0 0 0 0 0 0 0 0 - - - - - 
- - - - - - 0 0 0 0 0 0 0 0 0 0 0 0 0 0 c 0 0 0 0 0 0 0 0 0 0 0 0 0 0 - - - - - - 
- - - - - - - 0 0 0 0 0 0 1 2 0 0 0 0 - 0 - 0 0 0 0 3 4 0 0 0 0 0 0 - - - - - - - 
b - - - - - - - 0 0 0 0 0 2 1 0 0 0 0 0 - 0 0 0 0 0 4 3 0 0 0 0 0 - - - - - - - b 
0 b - - - - - - - 0 0 0 0 0 0 0 0 0 0 0 - 0 0 0 0 0 0 0 0 0 0 0 - - - - - - - b 0 
0 0 b - - - - - - - 0 0 0 0 0 0 0 0 0 0 - 0 0 0 0 0 0 0 0 0 0 - - - - - - - b 0 0 
0 0 0 b - - - - - - - 0 0 0 0 0 0 0 0 - - - 0 0 0 0 0 0 0 0 - - - - - - - b 0 0 0 
0 0 0 0 b - - - - - - - 0 0 0 0 0 0 - b - b - 0 0 0 0 0 0 - - - - - - - b 0 0 0 0 
0 0 0 0 0 b - - - - - - - 0 0 0 0 0 0 - - - 0 0 0 0 0 0 - - - - - - - b 0 0 0 0 0 
0 0 0 0 0 0 b - - - - - - - 0 0 0 0 - b - b - 0 0 0 0 - - - - - - - b 0 0 0 0 0 0 
c 0 0 0 0 0 0 b - - - - - - - 0 0 0 0 - b - 0 0 0 0 - - - - - - - b 0 0 0 0 0 0 c 
9 21 3 <-> 12 24 7
13 21 4 <-> 13 24 0
17 21 5 <-> 14 24 1
17 25 6 <-> 14 25 2
17 29 7 <-> 14 26 3
13 29 0 <-> 13 26 4
9 29 1 <-> 12 26 5
9 25 2 <-> 12 25 6
29 36 3 <-> 33 40 7
30 35 3 <-> 34 39 7
31 34 3 <-> 35 38 7
32 33 3 <-> 36 37 7
33 32 3 <-> 37 36 7
34 31 3 <-> 38 35 7
35 30 3 <-> 39 34 7
36 29 3 <-> 40 33 7
4 29 5 <-> 0 33 1
5 30 5 <-> 1 34 1
6 31 5 <-> 2 35 1
7 32 5 <-> 3 36 1
8 33 5 <-> 4 37 1
9 34 5 <-> 5 38 1
10 35 5 <-> 6 39 1
11 36 5 <-> 7 40 1
31 21 5 <-> 28 24 1
27 21 4 <-> 27 24 0
23 21 3 <-> 26 24 7
23 25 2 <-> 26 25 6
23 29 1 <-> 26 26 5
28 26 3 <-> 31 29 7
28 25 2 <-> 31 25 6
27 26 4 <-> 27 29 0
