4
3
2 2
24 24
- - 0 0 0 0 0 0 0 0 0 0 0 0 0 0 0 0 0 0 0 0 - -
- 0 0 0 0 0 0 0 0 0 0 0 0 0 0 0 0 0 0 0 0 0 0 -
0 0 0 0 0 0 0 0 0 0 0 0 0 0 0 0 0 0 0 0 0 0 0 0
0 0 0 0 0 - 0 0 0 0 0 0 0 0 0 0 0 0 - 0 0 0 0 0
0 0 0 0 0 - 0 0 0 0 0 0 0 0 0 0 0 0 - 0 0 0 0 0
0 0 0 0 0 - 0 0 0 0 0 0 0 0 0 0 0 0 - 0 0 0 0 0
0 0 - - - - - - - - b 0 0 b - - - - - - - - 0 0
0 0 0 0 0 - 0 0 0 - 0 0 0 0 - 0 0 0 - 0 0 0 0 0
0 0 0 0 0 - 0 0 0 0 0 0 0 0 0 0 0 0 - 0 0 0 0 0
0 0 0 0 0 - 0 0 0 i 0 0 0 0 i 0 0 0 - 0 0 0 0 0
0 0 0 0 0 - - 0 0 0 1 2 4 3 0 0 0 - - 0 0 0 0 0
0 0 0 0 0 0 0 0 0 0 3 1 2 4 0 0 0 0 0 0 0 0 0 0
0 0 0 0 0 0 0 0 0 0 4 3 1 2 0 0 0 0 0 0 0 0 0 0
0 0 0 0 0 - - 0 0 0 2 4 3 1 0 0 0 - - 0 0 0 0 0
0 0 0 0 0 - 0 0 0 i 0 0 0 0 i 0 0 0 - 0 0 0 0 0
0 0 0 0 0 - 0 0 0 0 0 0 0 0 0 0 0 0 - 0 0 0 0 0
0 0 0 0 0 - 0 0 0 - 0 0 0 0 - 0 0 0 - 0 0 0 0 0
0 0 - - - - - - - - b 0 0 b - - - - - - - - 0 0
0 0 0 0 0 - 0 0 0 0 0 0 0 0 0 0 0 0 - 0 0 0 0 0
0 0 0 0 0 - 0 0 0 0 0 0 0 0 0 0 0 0 - 0 0 0 0 0
0 0 0 0 0 - 0 0 0 0 0 0 0 0 0 0 0 0 - 0 0 0 0 0
0 0 0 0 0 0 0 0 0 0 0 0 0 0 0 0 0 0 0 0 0 0 0 0
- 0 0 0 0 0 0 0 0 0 0 0 0 0 0 0 0 0 0 0 0 0 0 -
- - 0 0 0 0 0 0 0 0 0 0 0 0 0 0 0 0 0 0 0 0 - -
0 11 6 <-> 23 11 2
0 12 6 <-> 23 12 2
11 23 4 <-> 11 0 0
12 23 4 <-> 12 0 0