4
6
4 2
30 30
0 0 0 0 0 0 0 0 0 0 - - 0 0 b b 0 0 - - 0 0 0 0 0 0 0 0 0 0 
0 c 0 0 0 0 0 0 0 0 - - - 0 0 0 0 - - - 0 0 0 0 0 0 0 0 c 0 
0 0 0 0 0 0 0 0 0 0 - - - - 0 0 - - - - 0 0 0 0 0 0 0 0 0 0 
0 0 0 0 0 0 0 0 0 0 - - - - - - - - - - 0 0 0 0 0 0 0 0 0 0 
0 0 0 0 1 2 0 0 0 0 - - - - - - - - - - 0 0 0 0 1 2 0 0 0 0 
0 0 0 0 2 1 0 0 0 0 - - - - 0 0 - - - - 0 0 0 0 2 1 0 0 0 0 
0 0 0 0 0 0 0 0 0 0 - - - 0 0 0 0 - - - 0 0 0 0 0 0 0 0 0 0 
0 0 0 0 0 0 0 0 0 0 - - 0 0 0 0 0 0 - - 0 0 0 0 0 0 0 0 0 0 
x x 0 0 0 0 0 0 0 0 - 0 0 0 - - 0 0 0 - 0 0 0 0 0 0 0 0 x x 
x x 0 0 0 0 0 0 0 0 0 0 0 - - - - 0 0 0 0 0 0 0 0 0 0 0 x x 
- - - - - - - - - 0 0 0 0 0 0 0 0 0 0 0 0 - - - - - - - - - 
- - - - - - - - 0 0 0 - i 0 - - 0 i - 0 0 0 - - - - - - - - 
0 - - - - - - 0 0 0 0 0 0 0 - - 0 0 0 0 0 0 0 - - - - - - 0 
0 0 - - - - 0 0 0 - 0 0 0 0 - - 0 0 0 0 - 0 0 0 - - - - 0 0 
b 0 0 - - 0 0 0 - - 0 - - - x x - - - 0 - - 0 0 0 - - 0 0 b 
b 0 0 - - 0 0 0 - - 0 - - - x x - - - 0 - - 0 0 0 - - 0 0 b 
0 0 - - - - 0 0 0 - 0 0 0 0 - - 0 0 0 0 - 0 0 0 - - - - 0 0 
0 - - - - - - 0 0 0 0 0 0 0 - - 0 0 0 0 0 0 0 - - - - - - 0 
- - - - - - - - 0 0 0 - i 0 - - 0 i - 0 0 0 - - - - - - - - 
- - - - - - - - - 0 0 0 0 0 0 0 0 0 0 0 0 - - - - - - - - - 
x x 0 0 0 0 0 0 0 0 0 0 0 - - - - 0 0 0 0 0 0 0 0 0 0 0 x x 
x x 0 0 0 0 0 0 0 0 - 0 0 0 - - 0 0 0 - 0 0 0 0 0 0 0 0 x x 
0 0 0 0 0 0 0 0 0 0 - - 0 0 0 0 0 0 - - 0 0 0 0 0 0 0 0 0 0 
0 0 0 0 0 0 0 0 0 0 - - - 0 0 0 0 - - - 0 0 0 0 0 0 0 0 0 0 
0 0 0 0 3 4 0 0 0 0 - - - - 0 0 - - - - 0 0 0 0 3 4 0 0 0 0 
0 0 0 0 4 3 0 0 0 0 - - - - - - - - - - 0 0 0 0 4 3 0 0 0 0 
0 0 0 0 0 0 0 0 0 0 - - - - - - - - - - 0 0 0 0 0 0 0 0 0 0 
0 0 0 0 0 0 0 0 0 0 - - - - 0 0 - - - - 0 0 0 0 0 0 0 0 0 0 
0 c 0 0 0 0 0 0 0 0 - - - 0 0 0 0 - - - 0 0 0 0 0 0 0 0 c 0 
0 0 0 0 0 0 0 0 0 0 - - 0 0 b b 0 0 - - 0 0 0 0 0 0 0 0 0 0  
14 2 4 <-> 14 5 0
15 2 4 <-> 15 5 0
2 14 2 <-> 5 14 6
2 15 2 <-> 5 15 6
24 14 2 <-> 27 14 6
24 15 2 <-> 27 15 6
14 24 4 <-> 14 27 0
15 24 4 <-> 15 27 0