4
2
2 2
24 24
0 0 0 0 0 0 0 0 0 0 0 0 0 0 0 0 0 0 0 0 0 0 0 0
0 0 0 0 0 0 0 0 0 0 0 0 0 0 0 0 0 0 0 0 0 0 0 0
0 0 0 0 0 0 0 0 0 0 0 0 0 0 0 0 0 0 0 0 0 0 0 0
0 0 0 0 0 0 0 0 0 0 0 0 0 0 0 0 0 0 0 0 0 0 0 0
0 0 0 0 - - - 0 0 0 0 0 0 0 0 0 0 - - - 0 0 0 0
0 0 0 - - - - - 0 - - - - - - 0 - - - - - 0 0 0
0 0 0 - - - - - - 0 0 0 0 0 0 - - - - - - 0 0 0
0 0 0 - - - - 0 0 0 0 0 0 0 0 0 0 - - - - 0 0 0
0 0 0 0 - - 0 0 0 0 0 0 0 0 0 0 0 0 - - 0 0 0 0
0 0 0 0 0 - 0 0 - - - 0 0 - - - 0 0 - 0 0 0 0 0
0 0 0 0 - 0 0 - - - - 0 0 - - - - 0 0 - 0 0 0 0
0 0 0 0 - 0 0 - - b - 0 0 - b - - 0 0 - 0 0 0 0
0 0 0 0 - 0 0 - - - - 0 0 - - - - 0 0 - 0 0 0 0
0 0 0 0 - 0 0 - - - 0 0 0 0 - - - 0 0 - 0 0 0 0
0 0 0 0 - 0 0 0 0 0 0 0 0 0 0 0 0 0 0 - 0 0 0 0
0 0 0 0 - 0 0 0 0 0 - - - - 0 0 0 0 0 - 0 0 0 0
0 0 0 0 0 - 0 0 0 0 0 - - 0 0 0 0 0 - 0 0 0 0 0
0 0 0 0 0 - 0 0 0 - 0 0 0 0 - 0 0 0 - 0 0 0 0 0
0 0 0 0 0 0 - 0 0 0 - - - - 0 0 0 - 0 0 0 0 0 0
0 0 0 0 0 0 0 - - 0 0 0 0 0 0 - - 0 0 0 0 0 0 0
0 0 3 4 0 0 0 0 0 - - - - - - 0 0 0 0 0 2 1 0 0
0 0 4 3 0 0 0 0 0 0 0 0 0 0 0 0 0 0 0 0 1 2 0 0
0 0 0 0 0 0 0 0 0 0 0 0 0 0 0 0 0 0 0 0 0 0 0 0
0 0 0 0 0 0 0 0 0 0 0 0 0 0 0 0 0 0 0 0 0 0 0 0
9 11 5 <-> 6 14 1
9 11 7 <-> 7 9 3
14 11 3 <-> 17 14 7
14 11 1 <-> 16 9 5
11 4 4 <-> 11 6 0
12 4 4 <-> 12 6 0
11 19 4 <-> 11 21 0
12 19 4 <-> 12 21 0