4
0
0 1
7 7
1 2 0 b 0 1 4
2 1 0 0 0 4 1
0 0 b i b 0 0
b 0 i x i 0 b
0 0 b i b 0 0
3 2 0 0 0 3 4
2 3 0 b 0 4 3