4
4
2 1
20 34
- - - - - c 0 0 0 0 0 0 0 0 0 b - - b 0 0 0 0 0 0 0 0 0 c - - - - - 
- - - - - 0 0 0 0 0 0 0 0 0 0 0 - - 0 0 0 0 0 0 0 0 0 0 0 - - - - - 
- - - - 0 0 0 0 0 0 0 0 0 0 0 0 - - 0 0 0 0 0 0 0 0 0 0 0 0 - - - - 
- - - - 0 0 0 0 0 0 0 0 0 0 0 0 - - 0 0 0 0 0 0 0 0 0 0 0 0 - - - - 
- - - 0 0 0 0 0 0 0 0 0 0 0 0 0 - - 0 0 0 0 0 0 0 0 0 0 0 0 0 - - - 
- - - 0 0 0 0 0 0 0 0 0 0 0 0 0 0 0 0 0 0 0 0 0 0 0 0 0 0 0 0 - - - 
- - 0 0 0 0 0 0 0 0 0 0 0 0 0 0 x x 0 0 0 0 0 0 0 0 0 0 0 0 0 0 - - 
- - 0 0 0 0 0 0 0 0 0 0 0 0 0 0 x x 0 0 0 0 0 0 0 0 0 0 0 0 0 0 - - 
- 0 0 0 0 0 0 0 0 0 0 0 0 0 0 0 0 0 0 0 0 0 0 0 0 0 0 0 0 0 0 0 0 - 
b 0 0 0 0 3 4 0 0 0 0 0 0 0 0 0 - - 0 0 0 0 0 0 0 0 0 2 1 0 0 0 0 b 
b 0 0 0 0 4 3 0 0 0 0 0 0 0 0 0 - - 0 0 0 0 0 0 0 0 0 1 2 0 0 0 0 b 
- 0 0 0 0 0 0 0 0 0 0 0 0 0 0 0 0 0 0 0 0 0 0 0 0 0 0 0 0 0 0 0 0 - 
- - 0 0 0 0 0 0 0 0 0 0 0 0 0 0 x x 0 0 0 0 0 0 0 0 0 0 0 0 0 0 - - 
- - 0 0 0 0 0 0 0 0 0 0 0 0 0 0 x x 0 0 0 0 0 0 0 0 0 0 0 0 0 0 - - 
- - - 0 0 0 0 0 0 0 0 0 0 0 0 0 0 0 0 0 0 0 0 0 0 0 0 0 0 0 0 - - - 
- - - 0 0 0 0 0 0 0 0 0 0 0 0 0 - - 0 0 0 0 0 0 0 0 0 0 0 0 0 - - - 
- - - - 0 0 0 0 0 0 0 0 0 0 0 0 - - 0 0 0 0 0 0 0 0 0 0 0 0 - - - - 
- - - - 0 0 0 0 0 0 0 0 0 0 0 0 - - 0 0 0 0 0 0 0 0 0 0 0 0 - - - - 
- - - - - 0 0 0 0 0 0 0 0 0 0 0 - - 0 0 0 0 0 0 0 0 0 0 0 - - - - - 
- - - - - c 0 0 0 0 0 0 0 0 0 b - - b 0 0 0 0 0 0 0 0 0 c - - - - - 
