4
2
2 2
25 25
0 0 0 0 0 0 - - 0 0 0 0 0 0 0 0 0 - - 0 0 0 0 0 0 
0 x 0 0 x 0 - - 0 0 0 0 0 0 0 0 0 - - 0 x 0 0 x 0 
0 0 2 4 0 0 - - 0 0 0 0 0 0 0 0 0 - - 0 0 3 1 0 0 
0 0 4 2 0 0 - - 0 0 0 - - - 0 0 0 - - 0 0 1 3 0 0 
0 x 0 0 x 0 - - 0 0 0 - x - 0 0 0 - - 0 x 0 0 x 0 
0 0 0 0 0 0 - - 0 0 0 - x - 0 0 0 - - 0 0 0 0 0 0 
- - - - - - - - 0 0 0 - x - 0 0 0 - - - - - - - - 
- - - - - - - - 0 0 0 - x - 0 0 0 - - - - - - - - 
0 0 0 0 0 0 0 0 0 0 0 - x - 0 0 0 0 0 0 0 0 0 0 0 
0 0 0 0 0 0 0 0 0 i 0 - x - 0 c 0 0 0 0 0 0 0 0 0 
0 0 0 0 0 0 0 0 0 0 0 - b - 0 0 0 0 0 0 0 0 0 0 0 
0 0 0 - - - - - - - - - - - - - - - - - - - 0 0 0 
0 0 0 - x x x x x x b - - - b x x x x x x - 0 0 0 
0 0 0 - - - - - - - - - - - - - - - - - - - 0 0 0 
0 0 0 0 0 0 0 0 0 0 0 - b - 0 0 0 0 0 0 0 0 0 0 0 
0 0 0 0 0 0 0 0 0 c 0 - x - 0 i 0 0 0 0 0 0 0 0 0 
0 0 0 0 0 0 0 0 0 0 0 - x - 0 0 0 0 0 0 0 0 0 0 0 
- - - - - - - - 0 0 0 - x - 0 0 0 - - - - - - - - 
- - - - - - - - 0 0 0 - x - 0 0 0 - - - - - - - - 
0 0 0 0 0 0 - - 0 0 0 - x - 0 0 0 - - 0 0 0 0 0 0 
0 x 0 0 x 0 - - 0 0 0 - x - 0 0 0 - - 0 x 0 0 x 0 
0 0 1 2 0 0 - - 0 0 0 - - - 0 0 0 - - 0 0 4 3 0 0 
0 0 2 1 0 0 - - 0 0 0 0 0 0 0 0 0 - - 0 0 3 4 0 0 
0 x 0 0 x 0 - - 0 0 0 0 0 0 0 0 0 - - 0 x 0 0 x 0 
0 0 0 0 0 0 - - 0 0 0 0 0 0 0 0 0 - - 0 0 0 0 0 0 
12 22 0 <-> 12 20 4
20 12 2 <-> 22 12 6
12 4 0 <-> 12 2 4
4 12 6 <-> 2 12 2
0 5 4 <-> 0 8 6
0 9 6 <-> 1 5 4
0 10 6 <-> 2 5 4
16 0 0 <-> 19 0 6
15 0 0 <-> 19 1 6
14 0 0 <-> 19 2 6
24 19 0 <-> 24 16 2
24 15 2 <-> 23 19 0
24 14 2 <-> 22 19 0
5 24 2 <-> 8 24 4
5 23 2 <-> 9 24 4
5 22 2 <-> 10 24 4
24 19 2 <-> 24 16 4
24 20 2 <-> 23 16 4
24 21 2 <-> 22 16 4
5 24 4 <-> 8 24 6
8 23 6 <-> 4 24 4
3 24 4 <-> 8 22 6
0 5 6 <-> 0 8 0
1 8 0 <-> 0 4 6
0 3 6 <-> 2 8 0
19 0 0 <-> 16 0 2
20 0 0 <-> 16 1 2
21 0 0 <-> 16 2 2
21 19 0 <-> 24 13 2
24 22 2 <-> 21 16 4
5 21 2 <-> 11 24 4
2 24 4 <-> 8 21 6
3 8 0 <-> 0 2 6
3 5 4 <-> 0 11 6
16 3 2 <-> 22 0 0
19 3 6 <-> 13 0 0
