4
1
2 1
16 10
0 0 0 0 0 0 0 0 - -
0 0 x 0 0 0 c 0 - -
0 0 0 0 0 0 0 0 - -
0 0 0 0 0 0 0 0 - -
0 0 0 0 0 0 0 0 0 0
0 0 b 0 0 0 0 2 4 0
0 0 0 0 0 0 0 4 2 0
0 0 0 0 0 0 0 0 0 0
0 0 0 - - - - 0 0 0
- - - - - 0 0 b 0 0
0 0 0 - - - - 0 0 0
0 c 0 0 0 0 0 0 0 0
0 0 0 0 0 0 0 0 0 0
0 0 1 3 0 0 0 x 0 0
0 0 3 1 0 0 0 0 - -
0 0 0 0 0 c 0 - - -
7 14 2 <-> 5 9 6
6 15 2 <-> 7 1 2
1 8 4 <-> 7 10 6
7 8 6 <-> 1 10 0