4
12
1 2
16 27
i 0 0 0 0 0 x x 0 0 0 0 0 0 0 0 0 0 0 0 0 0 0 0 0 0 0
0 0 0 0 0 0 x x 0 0 - - - - - 0 0 0 0 0 0 0 0 0 0 0 0
0 0 2 1 0 0 0 - - - - - - - - - - - 0 0 0 0 0 1 2 0 0
0 0 1 2 0 0 - - 0 - - - - - - - 0 - - 0 0 0 0 2 1 0 0
0 0 0 0 0 - - - - - - - i i - - - - - - 0 0 0 0 0 0 0
0 x 0 0 0 - - - - - - - - - - - - - - - - 0 0 0 0 0 0
0 0 x 0 0 - - - - 0 - - - - - - - 0 - - - 0 0 x 0 0 0
0 0 0 0 0 0 0 - - - - - - - - - - - - - - 0 0 0 x 0 0
0 0 0 0 0 0 0 0 - - - - - - - 0 - - - - 0 0 0 0 0 0 0
0 0 0 0 0 0 0 0 0 0 - - - - - - - - - - 0 0 0 0 0 0 0
0 0 0 0 0 0 0 0 0 0 0 0 0 - - - - - 0 0 0 0 0 0 0 0 0
0 0 0 0 0 0 0 0 0 0 0 0 0 0 - - 0 0 0 0 0 0 0 0 0 0 0
0 0 3 4 0 0 0 0 0 0 0 0 0 0 - - 0 0 x x 0 0 0 4 3 0 0
0 0 4 3 0 0 0 0 0 0 x x 0 0 - - 0 0 x x 0 0 0 3 4 0 0
0 0 0 0 0 0 0 0 0 0 x x 0 0 0 - 0 0 0 0 0 0 0 0 0 0 0
0 0 0 0 0 0 0 0 0 0 0 0 0 0 0 0 0 0 0 0 0 0 0 0 0 0 i
5 3 2 <-> 8 3 6
6 7 1 <-> 9 6 5
12 10 1 <-> 15 8 5
18 10 7 <-> 15 8 3
21 6 6 <-> 17 6 2
18 2 5 <-> 16 3 1
8 3 4 <-> 9 6 7
9 6 3 <-> 15 8 7
15 8 1 <-> 17 6 5
17 6 0 <-> 16 3 3
16 3 6 <-> 8 3 2
8 3 3 <-> 12 4 6
13 4 3 <-> 17 6 7
