4
1
3 1
20 20
- - - b 0 0 0 0 0 0 0 0 0 0 0 0 b - - - 
- - - 0 0 0 0 0 0 0 0 0 0 0 0 0 0 - - - 
- - - 0 0 0 0 0 0 0 0 0 0 0 0 0 0 - - - 
b 0 0 1 2 i 0 0 0 0 0 0 0 0 i 4 2 0 0 b 
0 0 0 2 1 i 0 0 0 0 0 0 0 0 i 2 4 0 0 0 
0 0 0 0 0 0 0 0 0 0 0 0 0 0 0 0 0 0 0 0 
0 0 0 0 0 0 0 0 0 0 0 0 0 0 0 0 0 0 0 0 
0 0 0 0 0 0 0 0 0 0 0 0 0 0 0 0 0 0 0 0 
0 0 0 0 0 0 0 0 - - - - 0 0 0 0 0 0 0 0 
0 0 0 0 0 0 0 0 - - - - 0 0 0 0 0 0 0 0 
0 0 0 0 0 0 0 0 - - - - 0 0 0 0 0 0 0 0 
0 0 0 0 0 0 0 0 - - - - 0 0 0 0 0 0 0 0 
0 0 0 0 0 0 0 0 0 0 0 0 0 0 0 0 0 0 0 0 
0 0 0 0 0 0 0 0 0 0 0 0 0 0 0 0 0 0 0 0 
0 0 0 0 0 0 0 0 0 0 0 0 0 0 0 0 0 0 0 0 
0 0 0 1 3 i 0 0 0 0 0 0 0 0 i 4 3 0 0 0 
b 0 0 3 1 i 0 0 0 0 0 0 0 0 i 3 4 0 0 b 
- - - 0 0 0 0 0 0 0 0 0 0 0 0 0 0 - - - 
- - - 0 0 0 0 0 0 0 0 0 0 0 0 0 0 - - - 
- - - b 0 0 0 0 0 0 0 0 0 0 0 0 b - - - 
16 17 2 <-> 3 17 6
16 18 2 <-> 3 18 6
16 19 2 <-> 3 19 6
16 0 2 <-> 3 0 6
3 1 6 <-> 16 1 2
16 2 2 <-> 3 2 6
17 3 0 <-> 17 16 4
18 16 4 <-> 18 3 0
19 3 0 <-> 19 16 4
2 16 4 <-> 2 3 0
1 3 0 <-> 1 16 4
0 3 0 <-> 0 16 4
