4
4
2 1
23 24
- - - - - - - - 0 0 0 i c 0 0 0 - - - - - - - - 
- - - - - - 0 0 0 0 0 0 0 0 0 0 0 0 - - - - - - 
- - - - 0 0 0 0 0 0 0 0 0 0 0 0 0 0 0 0 - - - - 
- - - 0 0 0 0 0 0 0 0 0 0 0 0 0 0 0 0 0 0 - - - 
- - 0 0 0 0 0 0 0 0 0 0 0 0 0 0 0 0 0 0 0 0 - - 
- 0 0 0 0 0 0 0 0 0 4 4 4 0 0 0 0 0 0 0 0 0 0 - 
- 0 0 0 0 0 0 0 0 0 3 3 3 0 0 0 0 0 0 0 0 0 0 - 
0 0 0 0 0 0 0 0 0 0 0 0 0 0 0 0 0 0 0 0 0 0 0 0 
0 0 0 0 0 0 0 0 0 x 0 0 0 x 0 0 0 0 0 0 0 0 0 0 
c 0 0 0 0 0 0 0 0 0 0 0 0 0 0 0 0 0 0 0 0 0 0 c 
- - - - - - - - - - 0 0 0 - - - - - - - - - - - 
- - - - - - - - - b 0 b 0 b - - - - - - - - - - 
- - - - - - - - - - 0 0 0 - - - - - - - - - - - 
c 0 0 0 0 0 0 0 0 0 0 0 0 0 0 0 0 0 0 0 0 0 0 c 
0 0 0 0 0 0 0 0 0 x 0 0 0 x 0 0 0 0 0 0 0 0 0 0 
0 0 0 0 0 0 0 0 0 0 0 0 0 0 0 0 0 0 0 0 0 0 0 0 
- 0 0 0 0 0 0 0 0 0 1 1 1 0 0 0 0 0 0 0 0 0 0 - 
- 0 0 0 0 0 0 0 0 0 2 2 2 0 0 0 0 0 0 0 0 0 0 - 
- - 0 0 0 0 0 0 0 0 0 0 0 0 0 0 0 0 0 0 0 0 - - 
- - - 0 0 0 0 0 0 0 0 0 0 0 0 0 0 0 0 0 0 - - - 
- - - - 0 0 0 0 0 0 0 0 0 0 0 0 0 0 0 0 - - - - 
- - - - - - 0 0 0 0 0 0 0 0 0 0 0 0 - - - - - - 
- - - - - - - - 0 0 0 i c 0 0 0 - - - - - - - - 
15 22 3 <-> 15 0 1
8 22 5 <-> 8 0 7
4 20 5 <-> 4 2 7
19 2 1 <-> 19 20 3
23 14 2 <-> 0 14 6
0 8 6 <-> 23 8 2
