4
0
0 2
22 27
- - - - - - - - - - - - - - - - - - - - - - - - - - - 
- - 0 0 0 0 0 0 0 0 0 - - 0 0 - - 0 0 0 0 0 0 0 0 0 - 
- 0 - - 0 0 0 0 0 0 0 - 0 0 c - - 0 0 0 0 0 0 0 - - 0 
- 0 0 - 0 0 0 0 0 0 0 - 0 0 0 - - 0 0 0 0 0 0 0 - 0 0 
- 0 0 - - 0 0 0 0 0 0 - 0 0 0 0 - 0 0 0 0 0 0 - - 0 0 
- 0 0 0 0 0 0 0 0 0 0 - 0 0 0 0 - 0 0 0 0 0 0 0 0 0 0 
- 0 0 0 0 0 0 0 0 0 0 - 0 0 0 0 - 0 0 0 0 0 0 0 0 0 0 
- 0 0 0 0 0 0 - 0 0 0 - 0 0 0 0 - 0 0 0 - 0 0 0 0 0 0 
- 0 0 0 0 0 0 - - - 0 - 0 0 0 0 - 0 - - - 0 0 0 0 0 0 
- 0 0 0 0 0 0 0 0 - 0 - b 0 0 b - 0 - 0 0 0 0 0 0 0 0 
- 0 0 0 2 1 0 0 0 0 - - - 0 0 - - - 0 0 0 0 3 4 0 0 0 
- 0 0 0 1 2 0 0 0 0 0 - - 0 0 - - 0 0 0 0 0 4 3 0 0 0 
- - 0 0 0 0 0 0 0 0 0 - - 0 0 - - 0 0 0 0 0 0 0 0 0 - 
- 0 - 0 0 0 0 0 0 0 0 - b 0 0 b - 0 0 0 0 0 0 0 0 - 0 
- 0 - - - 0 0 0 0 0 0 - 0 0 0 0 - 0 0 0 0 0 0 - - - 0 
- 0 0 0 - 0 0 0 0 0 0 - 0 0 0 0 - 0 0 0 0 0 0 - 0 0 0 
- 0 0 0 0 0 0 0 0 0 0 - 0 0 0 0 - 0 0 0 0 0 0 0 0 0 0 
- 0 0 0 0 0 0 0 0 0 0 - 0 0 0 0 - 0 0 0 0 0 0 0 0 0 0 
- 0 0 0 0 0 0 - - 0 0 - 0 0 0 0 - 0 0 - - 0 0 0 0 0 0 
- 0 0 0 0 0 0 0 - 0 0 - - 0 0 0 - 0 0 - 0 0 0 0 0 0 0 
- 0 0 0 0 0 0 0 - - 0 - - c 0 0 - 0 - - 0 0 0 0 0 0 0 
- 0 0 0 0 0 0 0 0 0 - - - 0 0 - - - 0 0 0 0 0 0 0 0 0 
26 21 4 <-> 14 1 0
10 20 4 <-> 9 21 2
2 1 6 <-> 1 2 0
25 1 2 <-> 26 2 0
18 21 6 <-> 17 20 4
1 21 4 <-> 13 21 4
10 1 0 <-> 13 20 7
17 1 0 <-> 14 2 3
15 13 0 <-> 12 13 0
15 9 4 <-> 12 9 4
10 1 1 <-> 13 20 6
13 20 5 <-> 10 1 2
17 1 6 <-> 14 2 2
14 2 1 <-> 17 1 7
14 11 1 <-> 1 13 5
13 11 5 <-> 26 13 3
