4
0
0 0
11 30
- - - - - - - - x 0 x 0 0 x 0 0 x 0 0 x 0 x - - - - - - - -
- - - - - - 0 0 0 0 0 0 0 0 0 0 0 0 0 0 0 0 0 0 - - - - - -
- - - - - 0 0 0 0 0 0 0 0 0 0 0 0 0 0 0 0 0 0 0 0 - - - - -
- - - - 0 0 0 0 0 0 0 0 0 0 0 0 0 0 0 0 0 0 0 0 0 0 - - - -
- - 0 0 0 0 0 0 1 3 0 0 0 0 0 0 0 0 0 0 1 3 0 0 0 0 0 0 - -
0 0 0 0 0 0 0 0 4 2 0 0 0 0 b b 0 0 0 0 4 2 0 0 0 0 0 0 0 0
- - 0 0 0 0 0 0 0 0 0 0 0 0 0 0 0 0 0 0 0 0 0 0 0 0 0 0 - -
- - - - 0 0 0 0 0 0 0 0 0 0 0 0 0 0 0 0 0 0 0 0 0 0 - - - -
- - - - - 0 0 0 0 0 0 0 c c 0 0 c c 0 0 0 0 0 0 0 - - - - -
- - - - - - 0 0 0 0 0 0 0 0 i i 0 0 0 0 0 0 0 0 - - - - - -
- - - - - - - - 0 0 0 0 0 0 0 0 0 0 0 0 0 0 - - - - - - - -
29 5 2 <-> 0 5 6
14 0 0 <-> 14 10 4
15 10 4 <-> 15 0 0