4
4
2 1
39 41
- - - - - - - - - - - - - - - - - - - - 0 - - - - - - - - - - - - - - - - - - - - 
- - - - - - - - - - - - - - - - - - - 0 0 0 - - - - - - - - - - - - - - - - - - - 
- - - - - - - - - - - - - - - - - - 0 0 0 0 0 - - - - - - - - - - - - - - - - - - 
- - - - - - - - - - - - - - - - i 0 0 0 0 0 0 0 i - - - - - - - - - - - - - - - - 
- - - - - - - - - - - - - - - - 0 0 0 0 0 0 0 0 0 - - - - - - - - - - - - - - - - 
- - - - - - - - - - - - - - - 0 0 0 b 0 0 0 0 0 0 0 - - - - - - - - - - - - - - - 
- - - - - - - - - - - - - - - - 0 0 b 0 0 0 0 0 0 - - - - - - - - - - - - - - - - 
- - - - - - - - - - - - - - i 0 0 0 0 0 0 0 0 0 0 0 i - - - - - - - - - - - - - - 
- - - - - - - - - - - - - - 0 0 0 0 0 1 2 0 0 0 0 0 0 - - - - - - - - - - - - - - 
- - - - - - - - - - - - - 0 0 0 0 0 0 2 1 0 0 0 0 0 0 0 - - - - - - - - - - - - - 
- - - - - - - - - - - - - - - 0 0 0 0 0 0 0 0 0 0 0 - - - - - - - - - - - - - - - 
- - - - - - - - - - - - i - 0 0 0 0 0 0 0 0 0 0 0 0 0 - i - - - - - - - - - - - - 
- - - - - - - - - - - - i 0 0 0 0 0 0 0 0 0 0 b 0 0 0 0 i - - - - - - - - - - - - 
- - - - - - - - - - - - 0 0 0 0 0 0 0 0 0 0 0 b 0 0 0 0 0 - - - - - - - - - - - - 
- - - - - - - - - - - 0 0 0 0 b 0 0 0 0 0 0 0 0 0 0 0 0 0 0 - - - - - - - - - - - 
- - - - - - - - - - - - - 0 0 b 0 0 0 0 0 0 0 0 0 0 0 0 - - - - - - - - - - - - - 
- - - - - - - - - - - - 0 0 0 0 0 0 0 0 0 0 0 0 0 0 0 0 0 - - - - - - - - - - - - 
- - - - - - - - - i - 0 0 0 0 0 2 3 0 0 0 0 0 0 0 0 0 0 0 0 - i - - - - - - - - - 
- - - - - - - - - i 0 0 0 0 0 0 3 2 0 0 0 0 0 0 0 2 4 0 0 0 0 i - - - - - - - - - 
- - - - - - - - - 0 0 0 0 0 0 0 0 0 0 0 0 b 0 0 0 4 2 0 0 0 0 0 - - - - - - - - - 
- - - - - - - - 0 0 0 0 0 0 0 0 0 0 0 0 0 b 0 0 0 0 0 0 0 0 0 0 0 - - - - - - - - 
- - - - - - - - - - 0 0 0 0 0 0 0 0 0 0 0 0 0 0 0 0 0 0 0 0 0 - - - - - - - - - - 
- - - - - - - i - 0 0 0 0 0 0 0 0 0 0 0 0 0 0 0 0 0 0 0 0 0 0 0 - i - - - - - - - 
- - - - - - - i 0 0 0 0 0 0 b 0 0 0 0 0 0 0 0 0 0 0 0 0 0 0 0 0 0 i - - - - - - - 
- - - - - - - 0 0 0 0 0 0 0 b 0 0 0 0 0 0 0 0 0 0 3 4 0 0 0 0 0 0 0 - - - - - - - 
- - - - - - 0 0 0 0 0 0 0 0 0 0 0 0 0 0 0 0 0 0 0 4 3 0 0 0 0 0 0 0 0 - - - - - - 
- - - - - 0 0 0 0 0 0 0 0 0 0 0 0 0 0 0 0 0 0 0 0 0 0 0 0 0 0 0 0 0 0 0 - - - - - 
- - - - - - - - 0 0 0 0 0 0 0 0 0 0 0 0 0 0 0 0 0 0 0 0 0 0 0 0 0 - - - - - - - - 
- - - - - - - 0 0 0 0 0 0 0 0 0 0 0 0 0 b 0 0 0 0 0 0 0 0 0 0 0 0 0 - - - - - - - 
- - - - i - 0 0 0 0 0 4 1 0 0 0 0 0 0 0 b 0 0 0 0 0 b 0 0 0 0 0 0 0 0 - i - - - - 
- - - - i 0 0 0 0 0 0 1 4 0 0 0 0 0 0 0 0 0 0 0 0 0 b 0 0 0 0 0 0 0 0 0 i - - - - 
- - - - 0 0 0 0 0 0 0 0 0 0 0 0 0 0 0 0 0 0 0 0 0 0 0 0 0 0 1 3 0 0 0 0 0 - - - - 
- - - 0 0 0 0 b 0 0 0 0 0 0 0 0 0 0 0 0 0 0 0 0 0 0 0 0 0 0 3 1 0 0 0 0 0 0 - - - 
- - 0 0 0 0 0 b 0 0 0 0 0 0 0 0 0 0 0 0 0 0 0 0 0 0 0 0 0 0 0 0 0 0 0 0 0 0 0 - - 
- 0 0 0 0 0 0 0 0 0 0 0 0 0 0 0 0 0 0 b b b 0 0 0 0 0 0 0 0 0 0 0 0 0 0 0 0 0 0 - 
0 0 0 0 0 0 0 0 0 0 0 0 0 0 0 0 0 x x x x x x x 0 0 0 0 0 0 0 0 0 0 0 0 0 0 0 0 0 
- - - - - - - - - - - - - - - - - x 0 0 0 0 0 x - - - - - - - - - - - - - - - - - 
- - - - - - - - - - - - - - - - - x 0 0 0 0 0 x - - - - - - - - - - - - - - - - - 
- - - - - - - - - - - - - - - - - x 0 0 0 0 0 x - - - - - - - - - - - - - - - - - 
5 26 6 <-> 11 14 6
20 38 4 <-> 20 0 0
35 26 2 <-> 29 14 2
0 35 5 <-> 15 5 6
40 35 3 <-> 25 5 2
