4
2
0 0
30 32
- - 0 0 0 0 0 0 0 0 0 0 0 0 - - - - - - - - - - - - - - - - - - 
- - 0 0 0 0 0 1 3 0 0 0 0 0 - - - - - - - - - - - - - - - - - - 
- - 0 0 0 0 0 3 1 0 0 0 0 0 - - - - - - - - - - - - - - - - - - 
- - 0 0 0 0 0 0 0 0 0 0 0 0 - - - - - - - - - - - - - - - - - - 
- - 0 0 0 0 0 0 0 0 0 0 0 0 - - - - - - - - - - - - - - - - - - 
- - - - - - - - - - - - - - - - - - - - - - - - - - - - - - - - 
- - - - - - - - - - - - - - 0 0 0 0 0 0 0 0 0 0 0 0 0 0 0 0 0 0 
- - - - - - - - - - - - - - 0 0 0 0 0 0 0 0 0 0 0 0 0 0 0 0 0 0 
- - - - - - - - - - - - - - 0 0 0 0 0 0 0 0 0 0 0 0 0 0 0 0 0 0 
- - - - - - - - - - - - - - 0 0 0 0 0 0 0 0 0 0 0 0 0 0 0 0 0 0 
- - - - - - - - - - - - - - 0 0 0 0 0 0 0 0 0 0 0 0 0 0 0 0 0 0 
- - - - - - - - - - - - - - 0 0 0 0 0 0 0 0 0 0 0 0 0 0 0 0 0 0 
- - - - - - - - - - - - - - 0 0 0 0 0 0 0 0 0 0 0 0 0 0 0 0 0 0 
- - - - - - - - - - - - - - 0 0 0 0 0 0 0 0 0 0 0 0 0 0 0 0 0 0 
- - - - - - - - - - - - - - 0 0 0 0 0 0 0 0 - - 0 0 0 0 0 0 0 0 
- - - - - - - - - - - - - - 0 0 0 0 0 0 0 0 - - 0 0 0 0 0 0 0 0 
- - - - - - - - - - - - - - 0 0 0 0 0 0 0 0 0 0 0 0 0 0 0 0 0 0 
- - - - - - - - - - - - - - 0 0 0 0 0 0 0 0 0 0 0 0 0 0 0 0 0 0 
- - - - - - - - - - - - - - 0 0 0 0 0 0 0 0 0 0 0 0 0 0 0 0 0 0 
- - - - - - - - - - - - - - 0 0 0 0 0 0 0 0 0 0 0 0 0 0 0 0 0 0 
- - - - - - - - - - - - - - 0 0 0 0 0 0 0 0 0 0 0 0 0 0 0 0 0 0 
- - - - - - - - - - - - - - 0 0 0 0 0 0 0 0 0 0 0 0 0 0 0 0 0 0 
- - - - - - - - - - - - - - 0 0 0 0 0 0 0 0 0 0 0 0 0 0 0 0 0 0 
- - - - - - - - - - - - - - 0 0 0 0 0 0 0 0 0 0 0 0 0 0 0 0 0 0 
- - - - - - - - - - - - - - - - - - - - - - - - - - - - - - - - 
- - 0 0 0 0 0 0 0 0 0 0 0 0 - - - - - - - - - - - - - - - - - - 
- - 0 0 0 0 0 0 0 0 0 0 0 0 - - - - - - - - - - - - - - - - - - 
- - 0 0 0 0 0 2 4 0 0 0 0 0 - - - - - - - - - - - - - - - - - - 
- - 0 0 0 0 0 4 2 0 0 0 0 0 - - - - - - - - - - - - - - - - - - 
- - 0 0 0 0 0 0 0 0 0 0 0 0 - - - - - - - - - - - - - - - - - - 
2 26 6 <-> 21 15 2
2 27 6 <-> 22 16 0
2 2 6 <-> 21 14 2
2 3 6 <-> 22 13 4
2 1 6 <-> 23 16 0
23 13 4 <-> 2 28 6
2 29 6 <-> 24 14 6
24 15 6 <-> 2 0 6
2 26 7 <-> 24 13 5
24 16 7 <-> 2 3 5
21 16 1 <-> 2 0 7
2 29 5 <-> 21 13 3
