4
0
0 0
13 13
1 2 0 0 0 0 - 0 0 0 0 1 2 
3 4 0 0 0 0 - 0 0 0 0 3 4
0 0 0 0 0 0 - 0 0 0 0 0 0
0 0 0 0 0 0 - 0 0 0 0 0 0
0 0 0 0 0 0 - 0 0 0 0 0 0
0 0 0 0 0 0 - 0 0 0 0 0 0
- - - - - - - - - - - - -
0 0 0 0 0 0 - 0 0 0 0 0 0
0 0 0 0 0 0 - 0 0 0 0 0 0
0 0 0 0 0 0 - 0 0 0 0 0 0
0 0 0 0 0 0 - 0 0 0 0 0 0
1 2 0 0 0 0 - 0 0 0 0 1 2
3 4 0 0 0 0 - 0 0 0 0 3 4
5 5 3 <-> 7 7 7
5 7 1 <-> 7 5 5
5 0 2 <-> 7 0 6
5 12 2 <-> 7 12 6
0 5 4 <-> 0 7 0
12 5 4 <-> 12 7 0
