4
8
1 1
11 22
0 - - - - - - 0 - - - - - - 0 - - - - - - 0
0 b 0 x x 0 0 0 0 0 x x 0 0 0 0 0 x x 0 b 0
0 0 0 0 0 0 0 0 0 0 0 0 0 0 0 0 0 0 0 0 0 0
0 0 0 0 0 0 0 0 0 0 0 0 0 0 0 0 0 0 0 0 0 0
x 0 0 0 0 1 2 0 0 0 0 0 0 0 0 0 3 4 0 0 x 0
x 0 0 0 0 2 1 0 0 0 0 0 0 0 0 0 4 3 0 0 x 0
0 0 0 0 0 0 0 0 0 0 0 0 0 0 0 0 0 0 0 0 0 0
0 0 0 0 0 0 0 0 0 0 0 0 0 0 0 0 0 0 0 0 0 0
0 0 0 0 0 0 0 0 0 0 0 0 0 0 0 0 0 0 0 0 0 0
0 b 0 0 x x 0 0 0 x x 0 0 0 0 0 x x 0 0 b 0
0 - - - - - - 0 - - - - - - 0 - - - - - - 0
0 1 6 <-> 21 1 2
0 2 6 <-> 21 2 2
0 3 6 <-> 21 3 2
0 4 6 <-> 21 4 2
0 5 6 <-> 21 5 2
0 6 6 <-> 21 6 2
0 7 6 <-> 21 7 2
0 8 6 <-> 21 8 2
0 9 6 <-> 21 9 2
0 10 6 <-> 21 10 2
0 0 7 <-> 21 10 3
0 10 5 <-> 21 0 1