4
4
2 1
14 10
- - - 0 0 0 0 0 0 0
- - - 0 0 0 0 3 4 0
- - - 0 0 0 c 4 3 0
- - - 0 0 0 0 0 0 0
0 0 0 0 1 2 0 0 0 0
0 0 b 0 2 1 0 0 0 0
0 0 0 0 0 0 0 c 0 0
0 0 0 - - - - 0 0 0
0 0 0 - - - - 0 0 0
0 c 0 - - - - b 0 0
0 0 0 - - - - 0 0 0
0 0 0 b 0 0 0 0 0 0
0 0 0 0 0 0 0 0 0 0
0 0 0 0 0 c 0 0 0 0
3 0 6 <-> 2 7 2
3 1 6 <-> 2 8 2
3 2 6 <-> 2 9 2
3 3 6 <-> 2 10 2
0 7 6 <-> 9 7 2
0 8 6 <-> 9 8 2
0 9 6 <-> 9 9 2
0 10 6 <-> 9 10 2
