4
1
0 3
34 34
x 0 0 0 0 b - - - - - - - - - - - - - - - - - - - - - - b 0 b 0 b -
0 0 0 0 0 0 - - - - - - - - - - - - - - - - - - - - - - 0 x 0 x 0 b
0 0 1 2 0 0 - - - - - - - - - - - - - - - - - - - - - - b 0 x 0 x 0
0 0 2 1 0 0 - - - - - - - - - 0 c 0 0 - - - - - - - - - 0 x 0 x 0 b
0 0 0 0 0 0 - - - - - - - 0 0 0 0 0 0 0 0 - - - - - - - b 0 x 0 x 0
b 0 0 0 0 x - - - - - 0 0 0 0 0 0 0 0 0 0 0 0 - - - - - - b 0 b 0 b
- - - - - - - - - 0 0 0 0 0 0 0 0 0 0 0 0 0 0 0 0 - - - - - - - - -
- - - - - - - - 0 0 0 0 0 0 0 0 0 0 0 0 0 0 0 0 0 0 - - - - - - - -
- - - - - - - 0 b 0 0 0 0 0 0 - - - - 0 0 0 0 0 0 b 0 - - - - - - -
- - - - - - 0 0 0 0 0 0 0 - - 0 0 0 0 - - 0 0 0 0 0 0 0 - - - - - -
- - - - - - 0 0 0 0 0 - - 0 0 0 0 0 0 0 0 - - 0 0 0 0 0 - - - - - -
- - - - - 0 0 0 0 0 - 0 0 0 0 x 0 0 0 0 0 0 0 - 0 0 0 0 0 - - - - -
- - - - - 0 0 0 0 0 - 0 0 0 x 0 x 0 0 0 0 0 0 - 0 0 0 0 0 - - - - -
- - - - 0 0 0 0 0 - 0 0 0 x 0 x 0 0 0 0 0 0 0 0 - 0 0 0 0 0 - - - -
- - - - 0 0 0 0 0 - 0 0 0 0 0 0 x 0 0 0 0 0 0 0 - 0 0 0 0 0 - - - -
- - - 0 0 0 0 0 - 0 0 0 0 0 0 x 0 x - 0 0 0 0 0 0 - 0 0 0 0 0 - - -
- - - 0 0 0 0 0 - 0 0 0 0 0 0 0 x x x 0 0 0 0 0 0 - 0 0 0 0 0 - - -
- - - 0 0 0 0 0 - 0 0 0 0 0 0 x x x 0 0 0 0 0 0 0 - 0 0 0 0 0 - - -
- - - 0 0 0 0 0 - 0 0 0 0 0 0 - x 0 x 0 0 0 0 0 0 - 0 0 0 0 0 - - -
- - - - 0 0 0 0 0 - 0 0 0 0 0 0 0 x 0 0 0 0 0 0 - 0 0 0 0 0 - - - -
- - - - 0 0 0 0 0 - 0 0 0 0 0 0 0 0 x 0 x 0 0 0 - 0 0 0 0 0 - - - -
- - - - - 0 0 0 0 0 - 0 0 0 0 0 0 x 0 x 0 0 0 - 0 0 0 0 0 - - - - -
- - - - - 0 0 0 0 0 - 0 0 0 0 0 0 0 x 0 0 0 0 - 0 0 0 0 0 - - - - -
- - - - - - 0 0 0 0 0 - - 0 0 0 0 0 0 0 0 - - 0 0 0 0 0 - - - - - -
- - - - - - 0 0 0 0 x 0 0 - - 0 0 0 0 - - 0 0 0 0 0 0 0 - - - - - -
- - - - - - - 0 b 0 0 x 0 0 0 - - - - 0 0 0 0 0 0 b 0 - - - - - - -
- - - - - - - - 0 0 0 0 x 0 0 0 0 0 0 0 0 0 0 0 0 0 - - - - - - - -
- - - - - - - - - 0 0 0 0 0 0 0 0 0 0 0 0 0 0 0 0 - - - - - - - - -
b 0 b 0 b - - - - - - 0 0 0 0 0 0 0 0 0 0 0 0 - - - - - x 0 0 0 0 b
0 x 0 x 0 b - - - - - - - 0 0 0 0 0 0 0 0 - - - - - - - 0 0 0 0 0 0
b 0 x 0 x 0 - - - - - - - - - 0 0 0 0 - - - - - - - - - 0 0 3 4 0 0
0 x 0 x 0 b - - - - - - - - - - - - - - - - - - - - - - 0 0 4 3 0 0
b 0 x 0 x 0 - - - - - - - - - - - - - - - - - - - - - - 0 0 0 0 0 0
- b 0 b 0 b - - - - - - - - - - - - - - - - - - - - - - b 0 0 0 0 x
