4
2
0 5
19 19
- 0 0 - 0 - 0 0 - 0 - 0 0 - 0 - 0 0 - 
0 2 1 0 0 0 0 0 0 0 0 0 0 0 0 0 3 4 0 
0 1 2 0 0 0 0 0 0 0 0 0 0 0 0 0 4 3 0 
- 0 0 - 0 - 0 0 - 0 - 0 0 - 0 - 0 0 - 
0 0 0 0 0 0 0 0 0 0 0 0 0 0 0 0 0 0 0 
- 0 0 - 0 - 0 0 - 0 - 0 0 - 0 - 0 0 - 
0 0 0 0 0 0 0 0 0 0 0 0 0 0 0 0 0 0 0 
0 0 0 0 0 0 0 0 0 0 0 0 0 0 0 0 0 0 0 
- 0 0 - 0 - 0 0 - 0 - 0 0 - 0 - 0 0 - 
0 0 0 0 0 0 0 0 0 b 0 0 0 0 0 0 0 0 0 
- 0 0 - 0 - 0 0 - 0 - 0 0 - 0 - 0 0 - 
0 0 0 0 0 0 0 0 0 0 0 0 0 0 0 0 0 0 0 
0 0 0 0 0 0 0 0 0 0 0 0 0 0 0 0 0 0 0 
- 0 0 - 0 - 0 0 - 0 - 0 0 - 0 - 0 0 - 
0 0 0 0 0 0 0 0 0 0 0 0 0 0 0 0 0 0 0 
- 0 0 - 0 - 0 0 - 0 - 0 0 - 0 - 0 0 - 
0 3 4 0 0 0 0 0 0 0 0 0 0 0 0 0 2 1 0 
0 4 3 0 0 0 0 0 0 0 0 0 0 0 0 0 1 2 0 
- 0 0 - 0 - 0 0 - 0 - 0 0 - 0 - 0 0 - 
2 0 0 <-> 2 0 0
0 2 6 <-> 0 2 6
18 1 2 <-> 18 4 2
18 7 2 <-> 18 11 2
18 14 2 <-> 18 17 2
16 18 4 <-> 12 18 4
9 18 4 <-> 6 18 4
2 18 4 <-> 0 17 6
0 14 6 <-> 0 11 6
0 7 6 <-> 0 4 6
0 1 6 <-> 1 0 0
4 0 0 <-> 7 0 0
11 0 0 <-> 14 0 0
