4
4
0 0
21 21
0 c 0 0 - - - - - - - - - - - - - 0 0 0 0
0 0 0 0 0 - - - - - - - - - - - 0 0 0 0 0
0 0 0 0 0 0 - - - - - - - - - 0 0 3 4 0 0
0 0 0 0 0 i 0 - - - - - - - 0 0 0 4 3 0 0
- 0 b 0 0 0 0 0 - - - - - 0 0 0 0 0 0 0 -
- - 0 0 0 0 0 0 0 - - - 0 0 0 0 0 0 0 - -
- - - 0 0 0 0 0 0 0 - 0 0 0 0 0 0 0 - - -
- - - - 0 0 0 0 0 0 0 0 0 0 0 0 0 - - - -
- - - - - 0 0 0 0 0 0 0 0 0 0 0 - - - - -
- - - - - - 0 0 0 0 0 0 0 0 0 - - - - - -
- - - - - - - 0 0 0 0 0 0 0 - - - - - - -
- - - - - - 0 0 0 0 0 0 0 0 0 - - - - - -
- - - - - 0 0 0 0 0 0 0 0 0 0 0 - - - - -
- - - - 0 0 0 0 0 0 0 0 0 0 0 0 0 - - - -
- - - 0 0 0 0 0 0 0 - 0 0 0 0 0 0 0 - - -
- - 0 0 0 0 0 0 0 - - - 0 0 0 0 0 0 0 - -
- 0 0 0 0 0 0 0 - - - - - 0 0 0 0 0 b 0 -
0 0 2 1 0 0 0 - - - - - - - 0 i 0 0 0 0 0
0 0 1 2 0 0 - - - - - - - - - 0 0 0 0 0 0
0 0 0 0 0 - - - - - - - - - - - 0 0 0 0 0
0 0 0 0 - - - - - - - - - - - - - 0 0 c 0
16 7 4 <-> 16 13 0
17 6 4 <-> 17 14 0
18 5 4 <-> 18 15 0
19 4 4 <-> 19 16 0
20 3 4 <-> 20 17 0
4 19 4 <-> 1 4 6
5 18 4 <-> 2 5 6
6 17 4 <-> 3 6 6
7 16 4 <-> 4 7 6
8 15 4 <-> 5 8 6
9 14 4 <-> 6 9 6