4
2
2 2
21 21
0 0 0 0 0 0 0 0 0 0 i 0 0 0 0 0 0 0 0 0 0
0 0 0 0 0 0 0 0 0 i - i 0 0 0 0 0 0 0 0 0
0 0 0 0 0 0 0 0 i - - - i 0 0 0 0 0 0 0 0
0 0 0 c c c c i c c c c c i c c c c 0 0 0
0 0 0 c - - i 0 0 0 0 0 0 0 i - - c 0 0 0
0 0 0 c - i 0 0 0 0 0 0 0 0 0 i - c 0 0 0
0 0 0 c i 0 0 0 0 0 0 0 0 0 0 0 i c 0 0 0
0 0 0 i 0 0 0 0 0 0 0 0 0 0 0 0 0 i 0 0 0
0 0 i c 0 0 0 0 1 0 0 0 2 0 0 0 0 c i 0 0
0 i - c 0 0 0 0 0 1 x 2 0 0 0 0 0 c - i 0
i - - c 0 0 0 0 0 x b x 0 0 0 0 0 c - - i
0 i - c 0 0 0 0 0 3 x 4 0 0 0 0 0 c - i 0
0 0 i c 0 0 0 0 3 0 0 0 4 0 0 0 0 c i 0 0
0 0 0 i 0 0 0 0 0 0 0 0 0 0 0 0 0 i 0 0 0
0 0 0 c i 0 0 0 0 0 0 0 0 0 0 0 i c 0 0 0
0 0 0 c - i 0 0 0 0 0 0 0 0 0 i - c 0 0 0
0 0 0 c - - i 0 0 0 0 0 0 0 i - - c 0 0 0
0 0 0 c c c c i c c c c c i c c c c 0 0 0
0 0 0 0 0 0 0 0 i - - - i 0 0 0 0 0 0 0 0
0 0 0 0 0 0 0 0 0 i - i 0 0 0 0 0 0 0 0 0
0 0 0 0 0 0 0 0 0 0 i 0 0 0 0 0 0 0 0 0 0
