4
3 
2 1
30 30
0 0 0 0 0 0 0 0 0 0 0 0 0 0 0 0 0 0 x 0 0 0 0 0 0 0 0 0 0 0
0 1 2 1 2 0 0 0 x 0 0 0 0 0 0 0 0 0 0 0 0 0 0 0 0 1 2 1 2 0
0 3 4 3 4 0 0 0 0 0 0 0 0 0 c 0 0 0 0 0 0 0 0 0 0 3 4 3 4 0
0 1 2 1 2 0 0 0 0 0 b 0 0 0 0 0 0 0 0 x 0 0 0 0 x 1 2 1 2 0
0 3 4 3 4 0 0 i 0 0 0 0 0 0 0 0 0 0 0 0 0 0 0 0 0 3 4 3 4 0
0 0 0 0 0 0 0 0 0 0 0 - - 0 0 0 0 0 0 0 0 0 0 0 0 0 0 0 0 0
0 0 0 0 0 0 0 0 0 0 0 - - 0 0 0 0 0 0 0 0 0 0 x 0 0 0 0 0 0
0 0 b 0 0 0 0 0 0 0 0 0 0 0 0 0 0 0 x 0 0 0 0 0 0 0 c 0 0 0
0 0 0 0 0 0 b 0 0 0 0 0 0 0 x 0 0 0 0 0 0 i 0 0 0 0 0 0 0 0
0 0 0 0 x 0 0 0 0 0 0 0 0 0 0 0 0 0 0 0 0 0 0 0 0 0 0 0 0 0
0 0 0 0 0 0 0 0 0 x 0 0 0 0 0 0 0 0 0 0 0 0 0 0 0 0 0 0 0 0
0 0 x 0 0 0 0 0 0 0 0 0 0 0 0 0 0 0 0 0 0 0 0 0 0 0 0 0 0 0
0 0 0 0 0 c 0 0 0 0 0 0 0 0 0 0 0 0 0 0 0 0 0 0 0 - - 0 0 0
0 0 0 0 0 0 0 0 0 i 0 0 0 c 0 x 0 0 0 x 0 0 0 c 0 - - 0 0 0
0 0 0 0 0 0 0 b 0 0 0 0 0 0 0 0 0 0 0 0 0 0 0 0 0 0 0 0 0 0
0 0 0 x 0 0 0 0 0 0 0 0 0 0 0 0 0 0 0 0 0 0 0 0 0 0 0 0 0 0
0 0 0 0 0 0 0 0 0 0 0 0 0 0 0 0 0 0 0 0 0 0 0 i 0 0 0 0 0 0
0 0 0 0 0 0 0 0 0 0 0 0 0 0 0 0 b 0 0 0 0 0 0 0 0 0 0 b 0 0
0 0 0 0 0 0 0 0 0 0 0 0 0 0 0 0 0 0 0 0 0 0 0 0 0 0 0 0 0 0
0 0 0 0 0 0 - - - 0 0 0 0 x 0 0 0 0 - - 0 0 0 x 0 0 0 0 0 0
0 x 0 0 0 0 - - - 0 0 0 0 0 0 0 0 0 - - 0 0 0 b 0 0 0 0 0 0
0 0 x 0 0 0 - - - 0 0 0 0 0 0 0 0 0 0 0 0 x 0 0 0 0 x 0 0 0
0 x 0 0 0 0 - - - 0 0 0 0 0 0 0 0 0 0 0 0 0 0 0 0 0 0 0 0 0
0 0 0 0 0 0 0 0 0 0 0 0 0 0 c 0 0 0 0 0 x 0 0 0 0 0 0 0 0 0
0 0 0 0 0 0 0 0 0 0 0 0 0 0 0 0 0 0 0 0 0 0 0 0 0 0 0 0 0 0
0 1 2 1 2 0 0 0 0 b 0 0 x 0 0 0 0 i 0 0 0 0 0 0 0 1 2 1 2 0
0 3 4 3 4 0 x 0 0 0 0 0 0 0 0 0 0 0 0 0 0 0 0 0 0 3 4 3 4 0
0 1 2 1 2 0 0 0 0 x 0 0 0 0 0 c 0 0 0 0 0 x 0 0 b 1 2 1 2 0
0 3 4 3 4 0 0 0 0 0 0 0 0 0 0 0 0 0 0 0 0 0 0 0 0 3 4 3 4 0
x 0 0 0 0 0 0 0 0 0 0 0 0 0 0 0 0 0 0 0 0 0 0 0 0 0 0 0 0 0
0 0 7 <-> 29 29 3
0 0 1 <-> 29 0 7
0 0 5 <-> 0 29 7
29 29 1 <-> 29 0 3
29 29 5 <-> 0 29 3
0 1 6 <-> 29 1 2
0 2 6 <-> 29 2 2
0 3 6 <-> 29 3 2
0 4 6 <-> 29 4 2
0 5 6 <-> 29 5 2
0 6 6 <-> 29 6 2
0 7 6 <-> 29 7 2
0 8 6 <-> 29 8 2
0 9 6 <-> 29 9 2
0 10 6 <-> 29 10 2
0 11 6 <-> 29 11 2
0 12 6 <-> 29 12 2
0 13 6 <-> 29 13 2
0 14 6 <-> 29 14 2
0 15 6 <-> 29 15 2
0 16 6 <-> 29 16 2
0 17 6 <-> 29 17 2
0 18 6 <-> 29 18 2
0 19 6 <-> 29 19 2
0 20 6 <-> 29 20 2
0 21 6 <-> 29 21 2
0 22 6 <-> 29 22 2
0 23 6 <-> 29 23 2
0 24 6 <-> 29 24 2
0 25 6 <-> 29 25 2
0 26 6 <-> 29 26 2
0 27 6 <-> 29 27 2
0 28 6 <-> 29 28 2
0 29 6 <-> 29 29 2
