4
15
20 0
50 50
0 0 0 0 0 0 0 0 0 0 0 0 0 0 0 0 0 - - - - - - - - - - 0 0 0 0 0 0 0 0 i b b - 0 0 0 0 0 0 0 0 0 0 0
0 1 2 0 0 0 0 0 0 0 0 0 0 0 0 0 0 - - - - - - - - - - 0 0 1 3 0 0 0 0 i b b - 0 0 0 1 4 0 0 0 0 0 0
0 2 1 1 0 0 0 0 0 0 0 0 0 0 0 0 0 - - - - - - - - - - 0 0 3 1 0 0 0 0 i b b - 0 0 0 4 1 0 0 0 0 0 0
0 0 0 1 0 0 0 0 0 0 0 0 0 0 0 0 0 - - - - - - - - - - 0 0 0 0 0 0 0 0 i b b - 0 0 0 0 0 0 0 0 0 0 0
0 0 0 b 2 0 0 0 0 0 0 0 0 0 0 0 0 - - - - - - - - - - 0 0 0 0 0 0 0 0 i b b - 0 0 0 0 0 0 0 0 0 0 0
0 0 0 2 b 0 0 0 0 0 0 0 0 0 0 0 0 - - - - - - - - - - 0 0 0 0 0 0 0 0 i b b - 0 0 0 0 0 0 0 0 0 0 0
0 0 0 0 2 i 0 0 0 0 0 0 0 0 0 0 0 - - - - - - - - - - 0 0 0 0 0 0 0 0 i b b - 0 0 0 0 0 0 0 0 0 0 0
0 0 0 0 2 b 0 0 0 0 0 0 0 0 0 0 0 - - - - - - - - - - 0 0 0 0 0 0 0 0 i b b - 0 0 0 0 0 0 0 0 0 0 0
0 0 0 0 0 1 2 0 0 0 0 0 0 0 0 0 0 - - - - - - - - - - 0 0 0 0 0 0 0 0 i b b - 0 0 0 0 0 0 0 0 0 0 0
0 0 0 0 2 1 1 0 0 0 0 0 0 0 0 0 0 - - - - - - - - - - 0 0 0 0 0 0 0 0 i b b x 0 0 0 0 0 0 0 0 0 0 0
0 0 0 0 0 0 0 0 0 0 0 0 0 0 0 0 0 - - - - - - - - - - 0 0 0 0 0 0 0 0 i b b - 0 0 0 0 0 0 0 0 0 0 0
0 0 0 0 0 0 0 - - - - - - - - - - - - - - - - - - - - - - - - - - - - - - b - 0 0 0 0 0 0 0 0 0 0 0
0 0 0 0 0 0 0 - - - - - - - - - - - - - - - - - - - - - - - - - - - - - - b - 0 0 0 0 0 0 0 0 0 0 0
0 0 0 0 0 0 0 - - - - - - - - - - - - b x x b x x b - - - - - - - - - - - b - 0 0 0 0 0 0 0 0 0 0 0
0 0 0 0 0 0 0 - - - - - - - - - - - - x - - - - - x - - - - - - - - - - - b - 0 0 0 0 0 0 0 0 0 0 0
0 0 0 0 0 0 0 - - - - - - - - - - - - x - - - - - x - - - - - - - - - - - b - 0 0 0 0 0 0 0 0 0 0 0
0 0 0 0 0 0 0 - - - - - - - - - - - - b x x b x x b - - - - - - - - - - - b - 0 0 0 0 0 0 0 0 0 0 0
0 0 0 0 0 0 0 0 0 0 0 0 0 0 0 0 0 - - - - - - - - - - 0 0 0 0 0 0 0 0 i b b - 0 0 0 0 0 0 0 0 0 0 0
0 0 0 0 0 0 0 0 0 0 0 0 0 0 0 0 0 - - - - - - - - - - 0 0 0 0 0 0 0 0 i b b - 0 0 0 0 0 0 0 0 0 0 0
0 0 0 0 0 0 0 0 0 0 0 0 0 0 0 0 0 - - - - - - - - - - 0 0 0 0 0 0 0 0 i b b - 0 0 0 0 0 0 0 0 0 0 0
0 0 0 0 0 0 0 0 0 0 b b 0 0 0 0 0 - - - - - - - - - - 0 0 0 0 0 0 0 0 i b b - 0 0 0 0 0 0 0 0 0 0 0
0 0 0 0 0 0 0 0 0 0 b b 0 0 0 0 0 - - - - - - - - - - 0 0 0 0 0 0 0 0 i b b - 0 0 0 0 0 0 0 0 0 0 0
0 0 0 0 0 0 0 0 0 0 0 0 0 0 0 0 0 - - - - - - - - - - 0 0 0 0 0 0 0 0 i b b - 0 0 0 0 0 0 0 0 0 0 0
0 0 0 0 0 0 0 0 0 0 0 0 0 0 0 0 0 i i i i i i i i i i 0 0 0 0 0 0 0 0 i b b - 0 0 0 0 0 0 0 0 0 0 0
0 0 0 0 0 0 0 0 0 0 0 0 0 0 0 0 0 - - - - - - - - - - 0 0 0 0 0 0 0 0 i b b - 0 0 0 0 0 0 0 0 0 0 0
0 0 0 0 0 0 3 0 0 0 0 0 0 0 0 0 0 - - - - - - - - - - 0 0 0 0 0 0 0 0 i b b - 0 0 0 0 0 0 0 0 0 0 0
0 0 0 0 2 3 4 0 0 0 0 0 0 0 0 0 0 - - - - - - - - - - 0 0 2 4 0 0 0 0 i b b - 0 0 0 3 4 0 0 0 0 0 0
0 x 0 0 3 2 0 0 0 0 0 0 0 0 0 0 0 - - - - - - - - - - 0 0 4 2 0 0 0 0 i b b c 0 0 0 4 3 4 0 0 0 0 0
0 x 0 0 0 0 0 0 0 0 0 0 0 0 0 0 0 - - - - - - - - - - 0 0 0 0 0 0 0 0 i b b - 0 0 0 4 0 3 0 0 0 0 0
0 x 0 0 0 0 0 0 0 0 0 0 0 0 0 0 0 - - - - - - - - - - 0 0 0 0 0 0 0 0 i b b - 0 0 0 4 4 4 0 0 0 0 0
0 0 0 0 0 0 0 0 0 0 0 0 0 0 0 0 0 - x x x x x x x x - 0 0 0 0 0 0 0 0 i b b - 0 0 0 0 0 0 0 0 0 0 0
0 0 0 0 0 0 0 0 0 0 0 0 0 0 0 0 0 - x x x x x x x x - 0 0 0 0 0 0 0 0 i b b - 0 0 0 4 0 4 0 0 0 0 0
0 0 0 0 0 0 0 0 0 0 0 0 0 0 0 0 0 - x x x b c x x x - 0 0 0 0 0 0 0 0 i b b - 0 0 0 0 3 0 0 0 0 0 0
0 0 0 0 0 0 0 0 0 0 0 0 0 0 0 0 0 - x x x c b x x x - 0 0 0 0 0 0 0 0 i b b - 0 0 0 0 0 0 0 0 0 0 0
0 0 0 0 0 0 0 0 0 0 0 0 0 0 0 0 0 - x x x x x x x x - 0 0 0 0 0 0 0 0 i b b - 0 0 0 0 0 0 0 0 0 0 0
0 0 0 0 0 0 0 0 0 0 0 0 0 0 0 0 0 - x x x x x x x x - 0 0 0 0 0 0 0 0 i b b - 0 0 0 0 0 0 0 0 0 0 0
0 0 0 0 0 0 0 0 0 0 0 0 0 0 0 0 0 - - - - - - - - - - 0 0 0 0 0 0 0 0 i b b - 0 0 0 0 0 0 0 0 0 0 0
0 0 0 0 0 0 0 0 0 0 0 0 0 0 0 0 0 x x x x x i b x c x 0 0 0 0 0 0 0 0 i b b - 0 0 0 0 0 0 0 0 0 0 0
0 0 0 0 0 0 0 0 0 0 0 0 0 0 0 0 0 - - - - - - - - - - 0 0 0 0 0 0 0 0 i b b - 0 0 0 0 0 0 0 0 0 0 0
0 0 0 0 0 0 0 0 0 0 0 0 0 0 0 0 0 x x x x x x x x x x 0 0 0 0 0 0 0 0 i b b - 0 0 0 0 0 0 0 0 0 0 0
0 0 0 - - - - - - - 0 0 0 0 0 0 0 - - - - - - - - - - 0 0 0 0 0 0 0 0 i b b - 0 0 0 0 0 0 0 0 0 0 0
0 0 0 - b x x x b - 0 0 0 0 0 0 0 - - - - - - - - - - 0 3 0 0 0 0 0 0 i b b - 0 0 0 0 0 0 0 0 0 0 0
0 0 0 - b x x x x - 0 0 0 0 0 0 0 - - - - - - - - - - 0 0 3 3 4 0 0 x x x x x 0 0 0 0 0 0 0 0 0 0 0
0 0 0 - b i x x x - 0 0 0 0 0 0 0 - - - - - - - - - - 0 3 4 2 3 0 0 0 i b b - 0 0 0 0 0 0 0 0 0 0 0
0 0 0 - b x x x x - 0 0 0 0 0 0 0 - - - - - - - - - - 0 0 3 4 4 0 0 0 i b b - 0 0 0 0 0 0 0 0 0 0 0
0 0 0 - b x x x b - 0 0 0 0 0 0 0 - - - - - - - - - - 0 0 0 0 0 0 0 0 i b b - 0 0 0 0 0 0 0 0 0 0 0
0 0 0 - - - - - - - 0 0 0 0 0 0 0 - - - - - - - - - - 0 0 0 0 0 0 0 0 i b b - 0 0 0 0 0 0 0 0 0 0 0
0 0 0 0 0 0 0 0 0 0 0 0 0 0 0 0 0 - - - - - - - - - - 0 0 0 0 0 0 0 0 i b b - 0 0 0 0 0 0 0 0 0 0 0
0 0 0 0 0 0 0 0 0 0 0 0 0 0 0 0 0 - - - - - - - - - - 0 0 0 0 0 0 0 0 i b b - 0 0 0 0 0 0 0 0 0 0 0
0 0 0 0 0 0 0 0 0 0 0 0 0 0 0 0 0 - - - - - - - - - - 0 0 0 0 0 0 0 0 i b b - 0 0 0 0 0 0 0 0 0 0 0
8 41 1 <-> 36 0 0
4 45 5 <-> 49 0 0
49 49 4 <-> 48 0 0
48 49 4 <-> 47 0 0
47 49 4 <-> 46 0 0
46 49 4 <-> 45 0 0
45 49 4 <-> 44 0 0
44 49 4 <-> 43 0 0
43 49 4 <-> 42 0 0
42 49 4 <-> 41 0 0
41 49 4 <-> 40 0 0
40 49 4 <-> 37 0 0
