4
0
2 2
15 13
1 1 1 1 1 1 - 2 2 2 2 2 2 
- - - - - - - - - - - - - 
0 0 0 0 0 0 0 0 0 0 0 0 0 
0 0 0 - - - - - - 0 0 0 0 
0 0 0 - c c c c - 0 0 0 0 
0 0 0 - b b b b - 0 0 0 0 
0 0 0 - i i i i - 0 0 0 0 
0 0 0 - - - - - - 0 0 0 0 
0 0 0 0 0 0 0 0 0 0 0 0 0 
0 0 0 0 3 2 1 0 0 0 0 0 0 
0 0 0 0 1 - 4 0 0 0 0 0 0
0 0 0 0 4 3 2 0 0 0 0 0 0 
0 0 0 0 0 0 0 0 0 0 0 0 0 
- - - - - - - - - - - - -
3 3 3 3 3 3 - 4 4 4 4 4 4 
