4
50
1 3
38 38
0 0 0 - 0 0 0 0 0 0 0 0 - 0 0 0 0 0 0 0 0 0 0 0 0 0 0 0 c 0 - 0 0 0 0 - 0 0
0 0 0 - 0 0 0 0 0 0 0 0 - 0 0 0 0 0 0 0 0 0 0 0 0 0 0 0 c 0 - 0 x x 0 - 0 0
0 0 - - - - 0 0 - - 0 0 - 0 0 - 0 0 - 0 0 - - - - - - - - - - 0 x x 0 - 0 0
0 0 - 0 0 - 0 0 - i 0 0 - 0 0 - 0 0 - 0 0 0 0 0 0 0 0 0 0 0 0 0 0 0 0 - 0 0
0 0 - c c - 0 0 - 0 i 0 - 0 0 - 0 0 - 0 0 0 0 0 0 0 0 0 0 0 0 0 0 0 - - 0 0
0 0 - 0 0 - 0 0 - - - - - 0 0 - 0 0 - - - - - - - - - - - - - - 0 0 - 0 0 0
0 0 - 0 0 - 0 0 0 0 0 0 0 0 0 - 0 0 - 0 0 0 0 0 0 0 0 0 0 0 0 0 0 0 - 0 i 0
0 0 - 0 0 - 0 0 0 0 0 0 0 0 0 - 0 0 - 0 0 0 0 0 0 0 0 0 0 0 0 0 0 0 - 0 0 0
0 0 - 0 0 - 0 0 - - - - - - - - 0 0 - 0 0 0 - - - - - - - - - - - - - - 0 0
0 0 - 0 0 - 0 0 - 0 0 0 0 0 0 - 0 0 - 0 0 0 - 0 0 0 0 0 0 0 0 0 0 0 0 - 0 0
0 0 - 0 0 - 0 0 - 0 1 2 3 4 0 - 0 0 - 0 0 0 - 0 4 1 2 3 0 0 0 0 0 0 0 - 0 0
0 0 - 0 0 - 0 0 - 0 3 4 1 2 0 - 0 0 - - 0 0 - 0 2 3 4 1 0 - 0 0 - 0 0 - 0 0
0 0 - 0 0 - 0 0 - 0 1 2 3 4 0 - 0 i 0 - 0 0 - 0 4 1 2 3 0 - 0 0 - 0 0 - 0 0
0 0 - 0 0 - 0 0 - 0 3 4 1 2 0 - 0 i 0 - 0 0 - 0 2 3 4 1 0 - 0 0 - 0 0 - 0 0
0 0 0 0 0 0 0 0 - 0 0 0 0 0 - - - - - - 0 0 - - 0 0 0 0 0 - 0 0 - 0 0 - 0 0
0 0 0 0 0 0 0 0 - - - - 0 0 - 0 0 0 0 0 0 0 0 - - - - - - - 0 0 - 0 0 - 0 0
0 0 - - - - - - - 0 0 0 0 0 - 0 b 0 0 0 0 b 0 - 0 0 0 0 0 0 0 0 - 0 0 - 0 0
0 0 - 0 0 0 0 0 0 0 0 0 0 0 - 0 0 0 0 0 0 0 0 - 0 0 0 0 0 0 0 0 - 0 0 - 0 0
0 0 - 0 0 0 0 0 0 0 0 0 0 0 - 0 0 0 b b 0 0 0 - 0 0 - - - - - - - 0 0 - 0 0
0 0 - 0 0 - - - - - - - - - - 0 0 0 b b 0 0 0 - 0 0 0 0 0 - 0 0 0 0 0 - 0 0
0 0 - 0 0 - 0 0 0 0 0 0 0 0 - 0 0 0 0 0 0 0 0 - 0 0 c c 0 - 0 0 0 0 0 - 0 0
0 0 - 0 0 - 0 0 0 0 0 0 0 0 - 0 b 0 0 0 0 b 0 - 0 0 0 0 0 - 0 0 0 0 0 - 0 0
0 0 - 0 0 - 0 0 - - - - 0 0 - 0 0 0 0 0 0 0 0 - - - - - - - - - - 0 0 - 0 0
0 0 - 0 0 - 0 0 - 0 0 0 0 0 - - - - - - - - - - 0 0 0 0 0 0 0 0 - 0 0 0 0 0
0 0 - 0 0 - 0 0 - 0 2 3 4 1 0 - 0 0 0 0 0 0 - 0 3 4 1 2 0 0 0 0 - 0 0 0 0 0
0 0 - 0 0 - 0 0 - 0 4 1 2 3 0 - 0 x x 0 0 0 - 0 1 2 3 4 0 - 0 0 - 0 0 - 0 0
0 0 - 0 0 - 0 0 - 0 2 3 4 1 0 - 0 x x 0 - 0 - 0 3 4 1 2 0 - 0 0 - 0 0 - 0 0
0 0 - 0 0 - 0 0 - 0 4 1 2 3 0 - 0 0 0 0 - 0 - 0 1 2 3 4 0 - 0 0 - 0 0 - 0 0
0 0 - 0 0 - 0 0 - 0 0 0 0 0 0 - - - - - - 0 - 0 0 0 0 0 0 - 0 0 - 0 0 - 0 0
0 0 - 0 0 - 0 0 - - - - - - - - 0 0 0 - 0 0 - - - - - - - - 0 0 - - - - 0 0
0 0 - 0 0 0 0 0 0 0 0 0 0 0 0 0 0 c 0 - 0 0 - 0 0 0 0 0 0 - 0 0 0 0 0 0 0 0
0 0 - 0 0 0 0 0 0 0 0 0 0 0 0 0 0 0 0 - 0 0 - 0 0 0 0 0 0 - 0 0 0 0 0 0 0 0
0 0 - - - - - - - - - 0 0 - 0 0 - 0 0 - 0 0 - - - - - 0 0 - - - - - - - 0 0
0 0 - i 0 0 0 - 0 0 0 0 0 - 0 0 - 0 0 0 0 0 - 0 0 0 0 0 0 0 0 0 0 c 0 - 0 0
0 0 - 0 i 0 0 - 0 0 0 0 0 - 0 0 - 0 0 0 0 0 - 0 0 0 0 0 0 0 0 0 0 c 0 - 0 0
0 0 - - - 0 0 - 0 0 - - - - 0 0 - 0 0 - - - - 0 0 - 0 0 - - - - - - - - 0 0
0 0 0 0 0 0 0 - 0 0 - 0 0 0 0 0 - 0 0 0 0 0 0 0 0 - 0 0 0 0 0 0 0 0 0 0 0 0
0 0 0 0 0 0 0 - 0 0 - 0 0 0 0 0 - 0 0 0 0 0 0 0 0 - 0 0 0 0 0 0 0 0 0 0 0 0
28 19 2 <-> 0 0 0
28 20 2 <-> 1 0 0
28 21 2 <-> 2 0 0
