2
0
0 0
22 39
- - - - - - - - - - - - - - - - - - - - - - - - - - - - - - - - - - - - - - -
- - - - - - - - - - - - - - - - - - - - - - - - - - - - - - - - - - - - - - -
- - c c c c c c c c c c c c c c c c c c c c c c c c c c c c c c c c c c c c -
- - c 0 0 0 0 0 0 0 0 0 0 0 0 0 0 0 0 0 0 0 0 0 0 0 0 0 0 0 0 0 0 0 0 0 0 c -
- - c 0 1 2 0 0 0 0 0 0 0 0 0 0 0 0 0 0 0 0 0 0 0 0 0 0 0 0 0 0 0 0 2 1 0 c -
- - c 0 2 1 0 0 0 0 0 0 0 0 0 0 0 0 0 0 0 0 0 0 0 0 0 0 0 0 0 0 0 0 1 2 0 c -
- - c 0 0 0 0 0 0 0 b b b b 0 0 0 0 0 b b b b 0 0 0 0 b b b b 0 0 0 0 0 0 c -
- - c 0 0 0 0 0 0 b b b b b b 0 0 0 b b b b b b 0 0 b b b b b 0 0 0 0 0 0 c -
- - c 0 0 0 0 0 b b b 0 0 b b b 0 b b b 0 0 b b b 0 b b b b b 0 0 0 0 0 0 c -
- - c 0 0 0 0 0 b b 0 0 0 0 0 0 0 b b 0 0 0 0 b b 0 0 0 b b b 0 0 0 0 0 0 c -
- - c 0 0 0 0 0 b b 0 0 0 0 0 0 0 b b b b 0 0 b b 0 0 0 b b b 0 0 0 0 0 0 c -
- - c 0 0 0 0 0 b b 0 0 b b b b 0 b b b b b b b b 0 0 0 b b b 0 0 0 0 0 0 c -
- - c 0 0 0 0 0 b b 0 0 b b b b 0 b b 0 0 b b b b 0 0 0 b b b 0 0 0 0 0 0 c -
- - c 0 0 0 0 0 b b 0 0 0 0 b b 0 b b 0 0 0 0 b b 0 0 0 b b b 0 0 0 0 0 0 c -
- - c 0 0 0 0 0 b b b 0 0 b b b 0 b b b 0 0 b b b 0 0 0 b b b 0 0 0 0 0 0 c -
- - c 0 0 0 0 0 0 b b b b b b 0 0 0 b b b b b b 0 0 b b b b b b 0 0 0 0 0 c -
- - c 0 0 0 0 0 0 0 b b b b 0 0 0 0 0 b b b b 0 0 0 b b b b b b 0 0 0 0 0 c -
- - c 0 2 1 0 0 0 0 0 0 0 0 0 0 0 0 0 0 0 0 0 0 0 0 0 0 0 0 0 0 0 0 1 2 0 c -
- - c 0 1 2 0 0 0 0 0 0 0 0 0 0 0 0 0 0 0 0 0 0 0 0 0 0 0 0 0 0 0 0 2 1 0 c -
- - c 0 0 0 0 0 0 0 0 0 0 0 0 0 0 0 0 0 0 0 0 0 0 0 0 0 0 0 0 0 0 0 0 0 0 c -
- - c c c c c c c c c c c c c c c c c c c c c c c c c c c c c c c c c c c c -
- - - - - - - - - - - - - - - - - - - - - - - - - - - - - - - - - - - - - - -
