2
0
0 0
20 20
- - - - - - - - - - - - - 0 b 0 0 - - -
- - - - - - - - - - - - 0 0 b 0 0 0 0 -
- - - - - - - - - - - 0 0 0 b 0 0 0 0 0
- - - - - - - - - - 0 0 0 0 b 0 0 0 0 0
- - 0 - - - - - - 0 0 0 0 0 b 0 0 0 0 0
- 0 0 0 - - - - 0 0 0 0 0 0 b 0 0 0 0 0
0 0 0 0 0 - - 0 0 0 0 0 0 0 b 0 0 0 0 0
0 0 0 0 0 0 0 0 0 0 0 0 0 - - 0 0 0 0 0
- 0 0 0 0 0 0 0 0 0 0 0 - - - 0 x x x 0
- - 0 0 0 2 1 2 0 0 0 - - - - 0 x x x 0
- - 0 0 0 1 2 1 0 0 0 - - - - 0 x x x 0
- 0 0 0 0 0 0 0 0 0 0 0 - - - 0 x x x 0
0 0 0 0 0 0 0 0 0 0 0 0 0 - - 0 0 0 0 0
0 0 0 0 0 - - 0 0 0 0 0 0 0 b 0 0 0 0 0
- 0 0 0 - - - - 0 0 0 0 0 0 b 0 0 0 0 0
- - 0 - - - - - - 0 0 0 0 0 b 0 0 0 0 0
- - - - - - - - - - 0 0 0 0 b 0 0 0 0 0
- - - - - - - - - - - 0 0 0 b 0 0 0 0 0
- - - - - - - - - - - - 0 0 b 0 0 0 0 -
- - - - - - - - - - - - - 0 b 0 0 - - -
0 12 5 <-> 0 7 7
0 13 5 <-> 0 6 7
1 13 5 <-> 1 6 7
1 14 5 <-> 1 5 7
2 14 5 <-> 2 5 7
2 15 5 <-> 2 4 7
