4
0
0 0
37 40
- - - - - - - 0 - - - - - - - - - - - - - - - - - - - - - - - - 0 - - - - - - -
- - - - - - 0 0 0 - - - - - - - - - - - - - - - - - - - - - - 0 0 0 - - - - - -
- - - - - - 0 0 0 - - - - - - - - - - - - - - - - - - - - - - 0 0 0 - - - - - -
- - - - - - 0 0 0 - - - - - - - - - - - - - - - - - - - - - - 0 0 0 - - - - - -
- - - - - 0 0 0 0 0 - - - - - - - - - - - - - - - - - - - - 0 0 0 0 0 - - - - -
- - - - - 0 0 x 0 0 - - - - - - - - - - - - - - - - - - - - 0 0 x 0 0 - - - - -
- - - - - 0 0 x 0 0 - - - - - - - - - - - - - - - - - - - - 0 0 x 0 0 - - - - -
- - - - 0 0 x x x 0 0 - - - - - - - - - - - - - - - - - - 0 0 x x x 0 0 - - - -
- - - - 0 0 x x x 0 0 - - - - - - - - - - - - - - - - - - 0 0 x x x 0 0 - - - -
- - - - 0 0 x x x 0 0 - - - - - - - - - - - - - - - - - - 0 0 x x x 0 0 - - - -
- - - - 0 0 x x x x 0 0 - - - - - - - - - - - - - - - - 0 0 x x x x 0 0 - - - -
- - - 0 0 x x x x x 0 0 - - - - - - - - - - - - - - - - 0 0 x x x x x 0 0 - - -
- - - 0 0 x x x x x x 0 0 - - - - - - - - - - - - - - 0 0 x x x x x x 0 0 - - -
- - - 0 0 x x x x x x 0 0 - - - - - - - - - - - - - - 0 0 x x x x x x 0 0 - - -
- - 0 0 0 0 0 0 0 0 0 0 0 0 0 0 0 0 0 0 0 0 0 0 0 0 0 0 0 0 0 0 0 0 0 0 0 0 - -
- - 0 0 0 0 0 0 0 0 0 0 0 0 0 0 0 0 0 0 0 0 0 0 0 0 0 0 0 0 0 0 0 0 0 0 0 0 - -
- - 0 0 0 0 0 0 0 0 0 0 0 0 0 0 0 0 0 0 0 0 0 0 0 0 0 0 0 0 0 0 0 0 0 0 0 0 - -
- 0 0 0 0 0 0 0 0 0 0 0 0 0 0 0 0 0 0 0 0 0 0 0 0 0 0 0 0 0 0 0 0 0 0 0 0 0 0 -
- 0 0 0 0 0 0 0 0 0 0 0 0 0 0 0 0 0 0 0 0 0 0 0 0 0 0 0 0 0 0 0 0 0 0 0 0 0 0 -
- 0 0 0 0 0 0 0 0 2 1 2 0 0 0 0 0 0 0 0 0 0 0 0 0 0 0 0 4 3 4 0 0 0 0 0 0 0 0 -
0 0 0 0 0 0 0 0 0 1 2 1 0 0 0 0 0 0 0 0 0 0 0 0 0 0 0 0 3 4 3 0 0 0 0 0 0 0 0 0
0 0 0 0 0 0 0 0 0 0 0 0 0 0 0 0 0 0 0 0 0 0 0 0 0 0 0 0 0 0 0 0 0 0 0 0 0 0 0 0
0 0 0 0 0 0 0 0 0 0 0 0 0 0 0 0 0 0 0 0 0 0 0 0 0 0 0 0 0 0 0 0 0 0 0 0 0 0 0 0
- 0 0 0 0 0 0 0 0 0 0 0 0 0 0 0 0 0 0 0 0 0 0 0 0 0 0 0 0 0 0 0 0 0 0 0 0 0 0 -
- - 0 0 0 0 0 0 0 0 0 0 0 0 0 0 0 0 0 0 0 0 0 0 0 0 0 0 0 0 0 0 0 0 0 0 0 0 - -
- - - - 0 0 0 0 0 0 0 0 0 0 0 0 0 0 0 0 0 0 0 0 0 0 0 0 0 0 0 0 0 0 0 0 - - - -
- - - - - - 0 0 0 0 0 0 0 0 0 0 0 0 0 0 0 0 0 0 0 0 0 0 0 0 0 0 0 0 0 - - - - -
- - - - - - 0 0 0 0 0 0 0 0 0 0 0 0 0 0 0 0 0 0 0 0 0 0 0 0 0 0 0 0 - - - - - -
- - - - - - - - 0 0 0 0 0 0 0 0 0 0 0 0 0 0 0 0 0 0 0 0 0 0 0 0 - - - - - - - -
- - - - - - - - - - 0 0 0 0 0 0 0 0 0 0 0 0 0 0 0 0 0 0 0 0 - - - - - - - - - -
- - - - - - - - - - - 0 0 0 0 0 0 0 0 0 0 0 0 0 0 0 0 0 0 - - - - - - - - - - -
- - - - - - - - - - - - 0 0 0 0 0 0 0 0 0 0 0 0 0 0 0 0 - - - - - - - - - - - -
- - - - - - - - - - - - - 0 0 0 0 0 0 0 0 0 0 0 0 0 0 - - - - - - - - - - - - -
- - - - - - - - - - - - - - - 0 0 0 0 0 0 0 0 0 0 - - - - - - - - - - - - - - -
- - - - - - - - - - - - - - - - - 0 0 0 0 0 0 - - - - - - - - - - - - - - - - -
- - - - - - - - - - - - - - - - - - 0 0 0 0 - - - - - - - - - - - - - - - - - -
- - - - - - - - - - - - - - - - - - - 0 0 - - - - - - - - - - - - - - - - - - -
7 0 0 <-> 32 0 0
