4
2
0 5 5 5
16 16
1 1 2 2 - - - - 0 0 0 0 - - - -
1 1 2 2 - - - - 0 0 0 0 - - - -
4 4 3 3 - - - - 0 0 0 0 - - - -
4 4 3 3 - - - - 0 0 0 0 - - - -
- - - - 1 1 2 2 - - - - 0 0 0 0
- - - - 1 1 2 2 - - - - 0 0 0 0
- - - - 4 4 3 3 - - - - 0 0 0 0
- - - - 4 4 3 3 - - - - 0 0 0 0
0 0 0 0 - - - - 1 1 2 2 - - - -
0 0 0 0 - - - - 1 1 2 2 - - - -
0 0 0 0 - - - - 4 4 3 3 - - - -
0 0 0 0 - - - - 4 4 3 3 - - - -
- - - - 0 0 0 0 - - - - 1 1 2 2
- - - - 0 0 0 0 - - - - 1 1 2 2
- - - - 0 0 0 0 - - - - 4 4 3 3
- - - - 0 0 0 0 - - - - 4 4 3 3
3 0 1 <-> 0 3 5
11 0 1 <-> 0 11 5
15 4 1 <-> 4 15 5
15 12 1 <-> 12 15 5
8 0 7 <-> 15 7 3
0 0 7 <-> 15 15 3
0 8 7 <-> 7 15 3
