2
10
3 3
14 14
0 0 0 0 0 0 0 0 0 0 0 0 0 0 
0 0 0 0 i 0 0 0 0 0 0 0 i 0 
0 0 0 0 0 0 0 0 0 0 0 0 0 0 
0 0 0 - - - - - - - - 0 0 0 
0 0 0 - - - - - - - - 0 0 0 
0 0 0 - - - - - - - - 0 0 0 
0 i 0 - - - b b - - - 0 0 0 
0 0 0 - - - b b - - - 0 0 0 
0 0 0 - - - - - - - - 0 0 0 
0 0 0 - - - - - - - - 0 c 0 
0 c 0 - - - - - - - - 0 0 0 
0 0 0 0 0 0 0 0 0 0 0 0 0 0 
0 0 0 0 0 1 2 0 0 0 c 0 0 0 
0 0 0 0 0 2 1 0 0 0 0 0 0 0 
6 6 7 <-> 0 0 7
7 6 1 <-> 13 0 1
6 7 5 <-> 0 13 5
7 7 3 <-> 13 13 3

