8
10
5 3
33 25
- - - - - - - - - 0 0 0 0 0 0 0 0 - - - - - - - -
- - - - - - - - 0 0 0 0 0 0 0 0 0 0 - - - - - - -
- - - - - - - - 0 0 0 0 0 0 0 0 0 0 - - - - - - -
- - - - - - - - 0 0 0 0 0 0 0 0 0 0 - - - - - - -
- - - - - - - - 0 0 5 6 0 0 7 8 0 0 - - - - - - -
- - - - - - - - 0 0 6 5 0 0 8 7 0 0 - - - - - - -
- - - - - - - - 0 0 5 6 0 0 7 8 0 0 - - - - - - -
- - - - - - - - 0 0 0 0 0 0 0 0 0 0 - - - - - - -
- - - - - - - - 0 0 0 0 0 0 0 0 0 0 - - - - - - -
- - - - - - - - 0 0 0 0 0 0 0 0 0 0 0 - - - - - -
- - - - - - - 0 0 0 0 0 0 0 0 0 0 0 0 - - - - - -
- - - - - - - 0 0 - 0 0 0 - - - 0 0 0 0 - - - - -
- - - - - - 0 0 0 - - - - - - - 0 0 0 0 0 - - - -
- - - - - 0 0 0 0 - - - - - - - 0 0 0 0 0 - - - -
- - - - 0 0 0 0 - - - - - - - - - 0 0 0 0 0 - - -
- - - - 0 0 0 0 - - - - - - - - - 0 0 0 0 0 0 - -
- - - 0 0 0 0 - - - - - - - - - - - 0 0 0 0 0 - -
- - - 0 0 0 0 - - - - - - - - - - - 0 0 0 0 0 0 -
- - - 0 0 0 - - - - - - - - - - - - - 0 0 0 0 0 -
- - 0 0 0 0 - - - - - - - - - - - - - 0 0 0 0 0 -
- - 0 0 0 0 - - - - - - - - - - - - - 0 0 0 0 0 -
- - 0 0 0 0 - - - - - - - - - - - - 0 0 0 0 0 0 -
- - 0 0 0 0 0 - - - - - - - - - - 0 0 0 0 0 0 0 -
0 0 0 0 0 0 0 0 - - - - - - - - - 0 0 0 0 0 0 0 0
0 0 0 0 0 0 0 0 0 - - - - - - - - 0 0 0 0 0 0 0 0
0 0 0 0 0 0 0 0 0 - - - - - - - - 0 0 0 0 0 0 0 0
0 0 0 1 2 0 0 0 0 - - - - - - - - 0 0 0 4 3 0 0 0
0 0 0 2 1 0 0 0 0 - - - - - - - 0 0 0 0 3 4 0 0 0
0 0 0 1 2 0 0 0 0 0 0 - - - 0 0 0 0 0 0 4 3 0 0 0
0 0 0 0 0 0 0 0 0 0 0 0 0 0 0 0 0 0 0 0 0 0 0 0 0
0 0 0 0 0 0 0 0 0 0 0 0 0 0 0 0 0 0 0 0 0 0 0 - -
- 0 0 0 0 0 0 0 0 0 - - - - - 0 0 0 0 0 0 0 - - -
- - - - - 0 0 0 0 - - - - - - - - 0 0 0 0 - - - -
8 13 3 <-> 16 27 7
16 13 5 <-> 10 28 1
5 20 2 <-> 19 20 6
